άγγλους	αγγλος
άγιος	αγιος
αγία	αγιος
αγίας	αγιος
αγίου	αγιος
αγίων	αγιος
άγνωστα	αγνωστος
άγνωστη	αγνωστος
άγρια	αγρια
άγρια	αγρια
άγριες	αγριος
άγριος	αγριος
άγριων	αγριος
άδεια	αδεια
άδειας	αδεια
άδειες	αδεια
άδωνις	αδωνις
αζώτου	αζωτο
άκαμπτο	ακαμπτος
άκρο	ακρο
άκρας	ακρος
άλλοθι	αλλοθι
αλλο	αλλος
άλλως	αλλως
άλλωστε	αλλωστε
άμαχοι	αμαχος
άμεσα	αμεσα
άμεσες	αμεσος
άμεση	αμεσος
άμεσο	αμεσος
άμμος	αμμος
άμμος	αμμος
άμμου	αμμος
άμρ	αμρ
άμστερνταμ	αμστερνταμ
αμστερνταμ	αμστερνταμ
άμυνας	αμυνα
αμύνης	αμυνα
άμυνα	αμυνα
ανέμων	ανεμος
άνεργο	ανεργος
άνεργοι	ανεργος
άνθρακα	ανθρακας
άνθρακα	ανθρακας
άνθρωπο	ανθρωπος
άνθρωποι	ανθρωπος
άνθρωπος	ανθρωπος
ανθρώπου	ανθρωπος
ανθρώπους	ανθρωπος
ανθρώπους	ανθρωπος
ανθρώπων	ανθρωπος
άνισο	ανισος
άνοδο	ανοδος
άνοιγμά	ανοιγμα
άνοιγμα	ανοιγμα
άνδρα	αντρας
άνδρας	αντρας
άνδρες	αντρας
άντρες	αντρας
άνω	ανω
ανωτέρω	ανω
ανώτερα	ανω
άξια	αξιος
άξιου	αξιος
άξονα	αξονας
αξόνων	αξονας
άουτ	αουτ
απέλπιδες	απελπις
άποικοι	αποικος
αποίκους	αποικος
άπορων	απορος
άποψή	αποψη
άποψής	αποψη
άποψη	αποψη
άποψης	αποψη
απόψεις	αποψη
άπραγοι	απραγος
άρθρα	αρθρο
άρθρο	αρθρο
άρθρου	αρθρο
άριστων	αριστος
άρνηση	αρνηση
άρνησης	αρνηση
άρρωστη	αρρωστος
άρσεναλ	αρσεναλ
άρσεναλ	αρσεναλ
άρση	αρση
άρσης	αρση
αρτέμιδος	αρτεμις
άσαντ	ασαντ
άσθμα	ασθμα
άσκηση	ασκηση
άσκησης	ασκηση
ασκήσεις	ασκηση
ασκήσεων	ασκηση
άσκοπο	ασκοπος
άστεγοι	αστεγος
άστοχη	αστοχος
άσυλο	ασυλο
άσχημη	ασχημος
άτομα	ατομο
άτομο	ατομο
ατόμων	ατομο
άτυχο	ατυχος
έβδομο	εβδομος
έβρο	εβρος
έγγραφα	εγγραφο
έγγραφο	εγγραφο
εγγράφου	εγγραφο
εγγράφων	εγγραφο
έγκαιρης	εγκαιρος
έγκειται	εγκειται
εγκλήματα	εγκλημα
εγκλήματος	εγκλημα
εγκλημάτων	εγκλημα
έγκριση	εγκριση
έδαφος	εδαφος
εδάφη	εδαφος
εδάφους	εδαφος
έδρα	εδρα
έθιμο	εθιμο
έθνη	εθνος
εθνών	εθνος
έθνη	εθνος
έθνος	εθνος
έιμος	ειμος
έκδοσή	εκδοση
έκδοση	εκδοση
έκδοσης	εκδοση
έκθεσή	εκθεση
έκθεσής	εκθεση
έκθεση	εκθεση
έκθεσης	εκθεση
εκθέσεις	εκθεση
έκκληση	εκκληση
έκπληξη	εκπληξη
εκπτώσεις	εκπτωση
έκπτωτο	εκπτωτος
έκρηξη	εκρηξη
έκρηξης	εκρηξη
εκρήξεις	εκρηξη
εκρήξεων	εκρηξη
εκτάκτων	εκτακτος
έκτακτης	εκτακτος
έκταση	εκταση
εκτάσεις	εκταση
έκτου	εκτος
έκφραση	εκφραση
έλατα	ελατο
ελέγχου	ελεγχος
έλεγχο	ελεγχος
έλεγχοι	ελεγχος
έλεγχος	ελεγχος
έλεγχό	ελεγχος
ελέγχου	ελεγχος
ελέγχους	ελεγχος
ελέγχων	ελεγχος
έλευση	ελευση
έλλειμμα	ελλειμμα
ελλείμματα	ελλειμμα
έλλειψη	ελλειψη
έλλειψης	ελλειψη
ελλείψεις	ελλειψη
έλληνες	ελληνας
έλληνες	ελληνας
ελλήνων	ελληνας
έλξης	ελξη
έμβλημα	εμβλημα
έμποροι	εμπορος
έμπορος	εμπορος
εμπόρους	εμπορος
εμπόρων	εμπορος
έμφαση	εμφαση
έναρξη	εναρξη
ένδειας	ενδεια
ένδειξη	ενδειξη
ένδειξης	ενδειξη
ενδείξεις	ενδειξη
έντεκα	ενδεκα
ένθερμους	ενθερμος
έννοια	εννοια
ένοπλα	ενοπλος
ένοπλες	ενοπλος
ένοπλοι	ενοπλος
ένορκοι	ενορκος
ένοχο	ενοχος
ένοχοι	ενοχος
ένταλμα	ενταλμα
εντάλματος	ενταλμα
ένταξής	ενταξη
ένταξη	ενταξη
έντασης	ενταση
έντονες	εντονος
έντονης	εντονος
έντονος	εντονος
εντονότατο	εντονος
έντουαρντ	εντουαρντ
ένωση	ενωση
ένωσης	ενωση
ενώσεως	ενωση
ένωση	ενωση
ένωσης	ενωση
έξαρση	εξαρση
έξοδα	εξοδο
έξοδο	εξοδος
εξόδου	εξοδος
έξυπνες	εξυπνος
έξω	εξω
έπαρση	επαρση
έπειτα	επειτα
έπειτα	επειτα
έργα	εργο
έργο	εργο
έργου	εργο
έργων	εργο
έρευνα	ερευνα
έρευνά	ερευνα
έρευνα	ερευνα
έρευνες	ερευνα
έρημο	ερημος
έρικ	ερικ
ήρθε	ερχομαι
έρθει	ερχομαι
έρθουμε	ερχομαι
έρθουν	ερχομαι
έρχεται	ερχομαι
έρχονται	ερχομαι
ήρθαν	ερχομαι
ήρθε	ερχομαι
έσοδα	εσοδο
έσοδο	εσοδο
έστω	εστω
έσω	εσω
έτιχαντ	ετιχαντ
έτοιμες	ετοιμος
έτοιμη	ετοιμος
έτοιμος	ετοιμος
έτη	ετος
έτος	ετος
έτους	ετος
ετών	ετος
έτσι	ετσι
έτσι	ετσι
έφεσή	εφεση
έχει	εχω
έχοντας	εχω
έχουμε	εχω
έχουν	εχω
έχω	εχω
είχε	εχω
έχει	εχω
έχετε	εχω
έχοντας	εχω
έχουμε	εχω
έχουν	εχω
έχω	εχω
είχα	εχω
είχαμε	εχω
είχαν	εχω
είχατε	εχω
είχε	εχω
ήδη	ηδη
ήδη	ηδη
ηπείρου	ηπειρος
ήπειρο	ηπειρος
ηπείρου	ηπειρος
ηπείρων	ηπειρος
ήπιες	ηπιος
ήτοι	ητοι
ήττα	ηττα
ήττα	ηττα
ίδια	ιδιος
ίδιας	ιδιος
ίδιας	ιδιος
ίδιες	ιδιος
ίδιο	ιδιος
ίδιοι	ιδιος
ίδιος	ιδιος
ίδιου	ιδιος
ίδιους	ιδιος
ιδρυμάτων	ιδρυμα
ίδρυσή	ιδρυση
ίδρυση	ιδρυση
ίσης	ισος
ίσες	ισος
ίσων	ισος
ίσως	ισως
ίσως	ισως
ίχνη	ιχνος
αll	αll
αέρα	αερας
αέρα	αερας
αέριο	αεριο
αερίου	αεριο
αερίου	αεριος
αερίου	αεριος
αέρος	αερος
αίγυπτο	αιγυπτος
αίγυπτος	αιγυπτος
αιγύπτου	αιγυπτος
αίθουσα	αιθουσα
αίματος	αιμα
αίρεται	αιρω
αίσιο	αισιος
αίτημα	αιτημα
αίτηση	αιτηση
αίτησης	αιτηση
αιτήσεις	αιτηση
αιτήσεων	αιτηση
αιτήσεως	αιτηση
αίτια	αιτιο
αβάσιμους	αβασιμος
αβοήθητοι	αβοηθητος
αβοήθητοι	αβοηθητος
αγαθά	αγαθο
αγαθών	αγαθο
αγαπημένους	αγαπαω
αγαπητοί	αγαπητος
αγγελιοφόρος	αγγελιοφορος
αγγλικά	αγγλικος
αγγλικούς	αγγλικος
αγιορείτες	αγιορειτης
αγνοούμενοι	αγνοουμενος
αγνοήσουμε	αγνοω
αγοράς	αγορα
αγορά	αγορα
αγοράς	αγορα
αγορές	αγορα
αγορών	αγορα
αγοράζονται	αγοραζω
αγοράσει	αγοραζω
αγοράσουμε	αγοραζω
αγοραστή	αγοραστης
αγρινίου	αγρινιο
αγριελιά	αγριελια
αγριογούρουνα	αγριογουρουνο
αγριοκάτσικο	αγριοκατσικο
αγριολούλουδα	αγριολουλουδο
αγωγή	αγωγη
αγωγοί	αγωγος
αγωνιζόμαστε	αγωνιζομαι
αγωνίστηκαν	αγωνιζομαι
αγωνιστή	αγωνιστης
αγόρια	αγορι
αγώνα	αγωνας
αγώνας	αγωνας
αδέλφια	αδερφι
αδίκημα	αδικημα
αδικήματα	αδικημα
αδικημάτων	αδικημα
αδίστακτος	αδιστακτος
αδελφοποιήσεις	αδελφοποιηση
αδελφοί	αδελφος
αδελφό	αδελφος
αδιάθετες	αδιαθετος
αδιαμφισβήτητη	αδιαμφισβητητος
αδιανόητοι	αδιανοητος
αδιευκρίνιστες	αδιευκρινιστος
αδικαιολόγητη	αδικαιολογητος
αδράνειά	αδρανεια
αδρανείς	αδρανης
αδρανών	αδρανης
αδυναμία	αδυναμια
αδυνατούμε	αδυνατω
αδόλφος	αδολφος
αδύνατη	αδυνατος
αεγχπ	αεγχπ
αειφόρο	αειφορο
αειφόρος	αειφορος
αειφόρου	αειφορος
αεροδρομίου	αεροδρομιο
αεροδρόμιο	αεροδρομιο
αεροπλάνου	αεροπλανο
αεροπορία	αεροπορια
αεροπορικώς	αεροπορικα
αεροπορικές	αεροπορικος
αεροπορικής	αεροπορικος
αεροσκάφη	αεροσκαφος
αεροσκάφος	αεροσκαφος
αεροσκάφους	αεροσκαφος
αθέμιτη	αθεμιτος
αθηνών	αθηνα
αθνάρ	αθναρ
αθωότητά	αθωοτητα
αθωότητας	αθωοτητα
αθώους	αθωος
αιγίδα	αιγιδα
αιγυπτιακά	αιγυπτιακος
αιγόγλαρο	αιγογλαρος
αιμολυτικά	αιμολυτικος
αισθανόμαστε	αισθανομαι
αισθητές	αισθητης
αισιοδοξία	αισιοδοξια
αιτία	αιτια
αιτίας	αιτια
αιτίες	αιτια
αιτιολογικές	αιτιολογικος
αιτιολογικής	αιτιολογικος
αιτιολογημένη	αιτιολογω
αιχμάλωτοι	αιχμαλωτος
αιχμάλωτος	αιχμαλωτος
αιχμής	αιχμη
αιχμαλωτίστηκαν	αιχμαλωτιζω
αιώνα	αιωνας
αιώνων	αιωνας
ακάλυπτος	ακαλυπτος
ακίνο	ακινο
ακαδημία	ακαδημια
ακαδημίας	ακαδημια
ακατανόητη	ακατανοητος
ακατοίκητα	ακατοικητος
ακατοίκητο	ακατοικητος
ακατόρθωτο	ακατορθωτος
ακεσαμναί	ακεσαμναι
ακινησίας	ακινησια
ήκμασε	ακμαζω
ακμή	ακμη
ακολουθώντας	ακολουθω
ακολούθησαν	ακολουθω
ακολούθησε	ακολουθω
ακολουθήθηκε	ακολουθω
ακολουθήσει	ακολουθω
ακολουθήσουμε	ακολουθω
ακολουθήσουν	ακολουθω
ακολουθεί	ακολουθω
ακολουθηθεί	ακολουθω
ακολουθούν	ακολουθω
ακολουθώντας	ακολουθω
ακούγοντας	ακουω
ακούγαμε	ακουω
ακούγεται	ακουω
ακούγονται	ακουω
ακούσαμε	ακουω
ακούσουμε	ακουω
ακούστηκαν	ακουω
ακραία	ακραιος
ακραίες	ακραιος
ακριβά	ακριβα
ακριβέστερα	ακριβης
ακριβέστερου	ακριβης
ακριβώς	ακριβως
ακριβώς	ακριβως
ακροαματική	ακροαματικος
ακροβολισμένοι	ακροβολιζομαι
ακροβούνι	ακροβουνι
ακρογωνιαίο	ακρογωνιαιος
ακρόαση	ακροαση
ακροπόλεις	ακροπολη
ακροπόλεων	ακροπολη
ακρόπολη	ακροπολη
ακρόπολης	ακροπολη
ακτίνα	ακτινα
ακτιβιστές	ακτιβιστης
ακτιβιστές	ακτιβιστης
ακτοπλοΐας	ακτοπλοια
ακυρωτικού	ακυρωτικος
ακυρώνει	ακυρωνω
ακυρώσει	ακυρωνω
ακύρωσε	ακυρωνω
ακόλουθο	ακολουθος
ακόμα	ακομα
ακόμη	ακομα
ακόμα	ακομα
ακόμη	ακομα
ακύρωση	ακυρωση
αλ	αλ
αλ	αλ
αλέξανδρο	αλεξανδρος
αλέξανδρος	αλεξανδρος
αλέξανδρου	αλεξανδρος
αλήθεια	αληθεια
αλήθεια	αληθεια
αλί	αλι
αλαμπάμα	αλαμπαμα
αλβανοί	αλβανος
αλγερία	αλγερια
αλγερινής	αλγερινος
αλεξάντερ	αλεξαντερ
αλεξέι	αλεξει
αλεξίπτωτο	αλεξιπτωτο
αλεξιπτωτιστών	αλεξιπτωτιστης
αληθεύει	αληθευω
αληθεύει	αληθευω
αλκοόλ	αλκοολ
άλλαξε	αλλαζω
αλλάξει	αλλαζω
αλλαγές	αλλαγη
αλλαγή	αλλαγη
αλλαγών	αλλαγη
αλλεπάλληλα	αλλεπαλληλος
αλληλεγγύη	αλληλεγγυη
αλληλεπίδραση	αλληλεπιδραση
αλληλογραφίας	αλληλογραφια
αλλιώς	αλλιως
αλλοδαποί	αλλοδαπος
αλλοδαπών	αλλοδαπος
αλλού	αλλου
αλυκή	αλυκη
αλυσίδες	αλυσιδα
αλφαβητισμού	αλφαβητισμος
αλοννήσου	αλοννησος
αλύτρωτη	αλυτρωτος
αμαξιών	αμαξι
αμέσως	αμεσως
αμέσως	αμεσως
αμερικανική	αμερικανικος
αμερικανικού	αμερικανικος
αμερικανικών	αμερικανικος
αμερικανική	αμερικανικος
αμερικανικής	αμερικανικος
αμερικανικό	αμερικανικος
αμερικανικών	αμερικανικος
αμερική	αμερικη
αμερικανοί	αμερικανος
αμερικανού	αμερικανος
αμερικανό	αμερικανος
αμερικανός	αμερικανος
αμερικανός	αμερικανος
αμερικανών	αμερικανος
αμερικανός	αμερικανος
αμερικανών	αμερικανος
αμνήστευση	αμνηστευση
αμνηστία	αμνηστια
αμνηστίας	αμνηστια
αμοιβαία	αμοιβαιος
αμοιβαίας	αμοιβαιος
αμοιβαίες	αμοιβαιος
αμπάς	αμπας
αμπιγιάν	αμπιγιαν
αμπντάλα	αμπνταλα
αμπντελμαλέκ	αμπντελμαλεκ
αμπντουλάχ	αμπντουλαχ
αμπντουραμάν	αμπντουραμαν
αμρ	αμρ
αμυντικής	αμυντικος
αμυρά	αμυρας
αμφιθεατρικά	αμφιθεατρικα
αμφιθεατρική	αμφιθεατρικος
αμφιλεγόμενα	αμφιλεγομενος
αμφισβήτησης	αμφισβητηση
αμφισβητούμενη	αμφισβητουμενος
αμφισβητεί	αμφισβητω
αμφισβητούνται	αμφισβητω
αμυνθεί	αμυνομαι
ανάγκες	αναγκη
ανάγκες	αναγκη
ανάγκη	αναγκη
ανάγκης	αναγκη
ανάγνωση	αναγνωση
αναγνώσεων	αναγνωση
ανάδοχοι	αναδοχος
αναδόχους	αναδοχος
ανάθεση	αναθεση
ανάθεσης	αναθεση
ανάκαμψη	ανακαμψη
ανάκρουση	ανακρουση
ανάκτησης	ανακτηση
ανάκτορο	ανακτορο
ανάληψη	αναληψη
ανάλογα	αναλογα
ανάλογα	αναλογα
ανάλογα	αναλογα
ανάλογα	αναλογος
ανάλογες	αναλογος
ανάλογη	αναλογος
ανάλογης	αναλογος
ανάλυσή	αναλυση
ανάλυση	αναλυση
αναλύσεις	αναλυση
ανάλωσης	αναλωση
ανάμικτες	αναμεικτος
ανάμειξη	αναμειξη
ανάμεσα	αναμεσα
ανάμεσά	αναμεσα
ανάμεσα	αναμεσα
ανάπαυσης	αναπαυση
ανάπλασης	αναπλαση
ανάπτυξη	αναπτυξη
ανάπτυξης	αναπτυξη
ανάρμοστης	αναρμοστος
ανέρχεται	ανερχομαι
ανέρχονται	ανερχομαι
ανήλθε	ανερχομαι
ανήκαν	ανηκω
ανήκει	ανηκω
ανήκουμε	ανηκω
ανήκουν	ανηκω
ανίτα	ανιτα
ανέβαλε	αναβαλλω
αναβολή	αναβολη
αναγγείλει	αναγγελλω
αναγκάζει	αναγκαζω
αναγκάζονται	αναγκαζω
αναγκάζουν	αναγκαζω
αναγκάσει	αναγκαζω
αναγκάσουν	αναγκαζω
αναγκάστηκαν	αναγκαζω
αναγκάστηκε	αναγκαζω
αναγκαζόμαστε	αναγκαζω
αναγκαστεί	αναγκαζω
αναγκαστούν	αναγκαζω
αναγκαία	αναγκαιος
αναγκαίο	αναγκαιος
αναγκαιότητα	αναγκαιοτητα
αναγκαστικά	αναγκαστικα
αναγκαστική	αναγκαστικος
αναγνωρίζει	αναγνωριζω
αναγνωρίσατε	αναγνωριζω
αναγνωρίζει	αναγνωριζω
αναγνωρίζονταν	αναγνωριζω
αναγνωρίζοντας	αναγνωριζω
αναγνωρίζουν	αναγνωριζω
αναγνωρίσει	αναγνωριζω
αναγνωρίσουμε	αναγνωριζω
αναγνωρίστηκε	αναγνωριζω
αναγνωρισθεί	αναγνωριζω
αναγνωριστεί	αναγνωριζω
αναγνώριση	αναγνωριση
αναγνώρισης	αναγνωριση
ανέδειξε	αναδεικνυω
αναδείχτηκε	αναδεικνυω
αναδιάρθρωσης	αναδιαρθρωση
αναδιαρθρώσεων	αναδιαρθρωση
αναδιπλωθούμε	αναδιπλωνω
αναζήτησης	αναζητηση
αναζητά	αναζητω
αναζητούν	αναζητω
αναζωογόνηση	αναζωογονηση
αναθέρμανση	αναθερμανση
αναθέτουσα	αναθετουσα
ανέθεσε	αναθετω
αναθέσει	αναθετω
ανατέθηκε	αναθετω
ανατεθεί	αναθετω
αναθέτουσας	αναθετων
αναθέτουσες	αναθετων
αναθεωρηθεί	αναθεωρω
αναθεώρησε	αναθεωρω
αναθεώρηση	αναθεωρηση
αναθεώρησης	αναθεωρηση
αναθεώρησης	αναθεωρηση
ανακάλυψη	ανακαλυψη
ανακάμψει	ανακαμπτω
ανακήρυξή	ανακηρυξη
ανακαινίσεις	ανακαινιση
ανακάλυψαν	ανακαλυπτω
ανακατασκευής	ανακατασκευη
ανακατονομή	ανακατονομη
ανακηρύξει	ανακηρυσσω
ανακοίνωση	ανακοινωση
ανακοίνωση	ανακοινωση
ανακοίνωσης	ανακοινωση
ανακοινώσεις	ανακοινωση
ανακοίνωσε	ανακοινωνω
ανακοινωθούν	ανακοινωνω
ανακοινώθηκαν	ανακοινωνω
ανακοινώνουν	ανακοινωνω
ανακοινώσει	ανακοινωνω
ανακούφιση	ανακουφιση
ανακρίτριας	ανακριτρια
ανακριτές	ανακριτης
ανακριτές	ανακριτης
ανακριτή	ανακριτης
ανακτήσουν	ανακτω
ανακτηθεί	ανακτω
ανακωχή	ανακωχη
ανακόλουθος	ανακολουθος
ανακόπτεται	ανακοπτω
ανακόψουν	ανακοπτω
ανακύψουν	ανακυπτω
ανέλαβε	αναλαμβανω
ανάλαβε	αναλαμβανω
ανέλαβαν	αναλαμβανω
ανέλαβε	αναλαμβανω
αναλάβει	αναλαμβανω
αναλάβετε	αναλαμβανω
αναλάβουν	αναλαμβανω
αναληφθεί	αναλαμβανω
αναληφθούν	αναλαμβανω
αναλογία	αναλογια
αναλογιστεί	αναλογιζομαι
αναλογικότητας	αναλογικοτητα
αναλογούντων	αναλογων
αναλυτές	αναλυτης
αναλυτικά	αναλυτικα
αναλυτικά	αναλυτικα
αναλυτική	αναλυτικος
αναλύσω	αναλυω
αναμέναμε	αναμενω
αναμένεται	αναμενω
αναμένει	αναμενω
αναμένεται	αναμενω
αναμένουμε	αναμενω
αναμένω	αναμενω
αναμέτρησης	αναμετρηση
αναμετρήσεις	αναμετρηση
αναμονή	αναμονη
αναμφίβολα	αναμφιβολα
ανανεώσουν	ανανεωνω
αναντίρρητα	αναντιρρητα
αναπαλαιωθεί	αναπαλαιωνω
αναπληρωτή	αναπληρωτης
αναπληρωτής	αναπληρωτης
αναπληρωτές	αναπληρωτης
αναπληρώτρια	αναπληρωτρια
αναπνευστικές	αναπνευστικος
αναπνοή	αναπνοη
αναποτελεσματικότητα	αναποτελεσματικοτητα
αναπροσαρμογή	αναπροσαρμογη
αναπτυξιακή	αναπτυξιακος
αναπτυσσόμενο	αναπτυσσομενος
ανέπτυξε	αναπτυσσω
αναπτυχθεί	αναπτυσσω
αναπτύξει	αναπτυσσω
αναπτύξουμε	αναπτυσσω
αναπτύσσεται	αναπτυσσω
αναπτύσσονται	αναπτυσσω
αναπτύχθηκε	αναπτυσσω
αναρίθμητες	αναριθμητος
αναρρίχηση	αναρριχηση
αναρωτηθώ	αναρωτιεμαι
ανασκαφές	ανασκαφη
ανασκαφική	ανασκαφικος
ανεστάλη	αναστελλω
ανασταλτικά	ανασταλτικα
αναστηλωθεί	αναστηλωνω
αναστολή	αναστολη
ανασύρθηκαν	ανασυρω
ανατολή	ανατολη
ανατολής	ανατολη
ανατολής	ανατολη
ανατολής	ανατολη
ανατολικά	ανατολικα
ανατολική	ανατολικος
ανατολικής	ανατολικος
ανατολικά	ανατολικος
ανατολική	ανατολικος
ανατολικής	ανατολικος
ανέτρεψε	ανατρεπω
ανατρέπουν	ανατρεπω
ανατροπή	ανατροπη
ανέφερα	αναφερω
αναφέρομαι	αναφερω
αναφέρω	αναφερω
αναφερθήκατε	αναφερω
ανάφερε	αναφερω
ανέφερα	αναφερω
ανέφεραν	αναφερω
ανέφερε	αναφερω
αναφέρατε	αναφερω
αναφέρει	αναφερω
αναφέρεται	αναφερω
αναφέρθηκαν	αναφερω
αναφέρθηκε	αναφερω
αναφέρομαι	αναφερω
αναφέρονται	αναφερω
αναφέροντας	αναφερω
αναφέρουν	αναφερω
αναφέρω	αναφερω
αναφερθήκατε	αναφερω
αναφερθώ	αναφερω
αναφερόμαστε	αναφερω
αναφερόμενη	αναφερομενος
αναφορά	αναφορα
αναφοράς	αναφορα
αναφορές	αναφορα
αναφορικά	αναφορικα
αναχωρήσει	αναχωρω
αναχωρούν	αναχωρω
αναχώρησαν	αναχωρω
αναχώρησε	αναχωρω
αναψυκτήρια	αναψυκτηριο
αναψυχής	αναψυχη
ανδρικό	ανδρικος
ανεμοστρόβιλοι	ανεμοστροβιλος
ανεμοστρόβιλοι	ανεμοστροβιλος
ανεμοστρόβιλους	ανεμοστροβιλος
ανεμοστρόβιλων	ανεμοστροβιλος
ανεμόμυλοι	ανεμομυλος
ανεξάρτητα	ανεξαρτητα
ανεξάρτητου	ανεξαρτητος
ανεξάρτητα	ανεξαρτητος
ανεξάρτητες	ανεξαρτητος
ανεξάρτητη	ανεξαρτητος
ανεξάρτητης	ανεξαρτητος
ανεξάρτητοι	ανεξαρτητος
ανεξάρτητου	ανεξαρτητος
ανεξάρτητους	ανεξαρτητος
ανεξαιρέτως	ανεξαιρετα
ανεξαρτησίας	ανεξαρτησια
ανεξαρτησία	ανεξαρτησια
ανεξαρτησίας	ανεξαρτησια
ανεπίτρεπτη	ανεπιτρεπτος
ανεπαρκή	ανεπαρκης
ανεπαρκής	ανεπαρκης
ανεπιθύμητες	ανεπιθυμητος
ανεπιφύλακτα	ανεπιφυλακτα
ανεπτυγμένες	ανεπτυγμενος
ανεργία	ανεργια
ανεργίας	ανεργια
ανεφοδιασμού	ανεφοδιασμος
ανησυχία	ανησυχια
ανησυχίες	ανησυχια
ανησυχητική	ανησυχητικος
ανησυχητικό	ανησυχητικος
ανησυχώ	ανησυχω
ανησυχεί	ανησυχω
ανησυχούν	ανησυχω
ανθρωπιστικών	ανθρωπιστικος
ανθρωπιστικές	ανθρωπιστικος
ανθρωπιστική	ανθρωπιστικος
ανθρωπιστικού	ανθρωπιστικος
ανθρωπιστικών	ανθρωπιστικος
ανθρωπότητας	ανθρωποτητα
ανθρώπινα	ανθρωπινος
ανθρωπίνων	ανθρωπινος
ανθρώπινα	ανθρωπινος
ανθρώπινης	ανθρωπινος
ανθρώπινο	ανθρωπινος
ανθρώπινου	ανθρωπινος
άνοιξαν	ανοιγω
άνοιξε	ανοιγω
ανοίγουν	ανοιγω
ανοίξει	ανοιγω
ανοίξουν	ανοιγω
ανοίχθηκε	ανοιγω
ανοικοδομήθηκαν	ανοικοδομω
ανοικοδομηθούν	ανοικοδομω
ανοικοδόμησή	ανοικοδομηση
ανοικοδόμησης	ανοικοδομηση
ανοιχτά	ανοικτα
ανοικτές	ανοιχτος
ανοικτή	ανοιχτος
ανοιχτές	ανοιχτος
ανοιχτή	ανοιχτος
ανοιχτής	ανοιχτος
ανοιχτού	ανοιχτος
ανοιχτό	ανοιχτος
ανοργάνωτη	ανοργανωτος
ανουάρ	ανουαρ
ανσάρ	ανσαρ
αντάρτες	ανταρτης
ανταρτών	ανταρτης
αντάρτικα	ανταρτικος
αντάρτικος	ανταρτικος
αντάρτικων	ανταρτικος
αντίδρασή	αντιδραση
αντίδραση	αντιδραση
αντίδρασης	αντιδραση
αντιδράσεις	αντιδραση
αντίθετα	αντιθετα
αντιθέτως	αντιθετα
αντίθετα	αντιθετα
αντιθέτως	αντιθετα
αντίθετη	αντιθετος
αντίθετο	αντιθετος
αντίκτυπο	αντικτυπος
αντικτύπου	αντικτυπος
αντίπαλες	αντιπαλος
αντίπαλοι	αντιπαλος
αντίπαλοι	αντιπαλος
αντιπάλους	αντιπαλος
αντίποινα	αντιποινο
αντιρρήσεις	αντιρρηση
αντίσταση	αντισταση
αντίσταση	αντισταση
αντίστοιχα	αντιστοιχα
αντίστοιχα	αντιστοιχος
αντίστοιχες	αντιστοιχος
αντίστοιχη	αντιστοιχος
αντίστοιχο	αντιστοιχος
αντίστοιχου	αντιστοιχος
αντίτυπα	αντιτυπο
αντίτυπο	αντιτυπο
ανταγωνισμού	ανταγωνισμος
ανταγωνισμούς	ανταγωνισμος
ανταγωνισμό	ανταγωνισμος
ανταγωνισμός	ανταγωνισμος
ανταγωνιστικές	ανταγωνιστικος
ανταγωνιστικού	ανταγωνιστικος
αντήλλαξε	ανταλλαζω
ανταλλαγή	ανταλλαγη
ανταλλαγής	ανταλλαγη
ανταλλαγών	ανταλλαγη
ανταποκρίθηκε	ανταποκρινομαι
ανταποκρίνεται	ανταποκρινομαι
ανταποκριθεί	ανταποκρινομαι
ανταποκριθούμε	ανταποκρινομαι
ανταποκριθούν	ανταποκρινομαι
ανταπόδοση	ανταποδοση
αντεκδίκησης	αντεκδικηση
αντιαεροπορικό	αντιαεροπορικος
αντιβασίλισσα	αντιβασιλισσα
αντιβασιλέα	αντιβασιλεας
αντιδιαστολή	αντιδιαστολη
αντέδρασε	αντιδρω
αντιδράσουμε	αντιδρω
αντιζηλιών	αντιζηλια
αντικαθιστώντας	αντικαθιστω
αντικατέστησε	αντικαθιστω
αντικαταστήσει	αντικαθιστω
αντικατασταθεί	αντικαθιστω
αντικατάσταση	αντικατασταση
αντικατοπτρίζει	αντικατοπτριζω
αντικείμενα	αντικειμενο
αντικείμενα	αντικειμενο
αντικείμενο	αντικειμενο
αντικειμενικό	αντικειμενικος
αντικομμουνιστική	αντικομμουνιστικος
αντικυβερνητικής	αντικυβερνητικος
αντικυβερνητικών	αντικυβερνητικος
αντιλαμβανόμαστε	αντιλαμβανομαι
αντιληφθήκαμε	αντιλαμβανομαι
αντιμέτωποι	αντιμετωπος
αντιμέτωπη	αντιμετωπος
αντιμέτωπους	αντιμετωπος
αντιμαχομένων	αντιμαχομενος
αντιμετωπίζει	αντιμετωπιζω
αντιμετωπίζεται	αντιμετωπιζω
αντιμετωπίζουμε	αντιμετωπιζω
αντιμετωπίζουν	αντιμετωπιζω
αντιμετωπίσει	αντιμετωπιζω
αντιμετωπίσουμε	αντιμετωπιζω
αντιμετωπίσουν	αντιμετωπιζω
αντιμετωπιστεί	αντιμετωπιζω
αντιμετώπιζε	αντιμετωπιζω
αντιμετώπισε	αντιμετωπιζω
αντιμετώπισης	αντιμετωπιση
αντιμετώπισή	αντιμετωπιση
αντιμετώπιση	αντιμετωπιση
αντιμετώπισης	αντιμετωπιση
αντιπαράθεση	αντιπαραθεση
αντιπαράθεσης	αντιπαραθεση
αντιπαραθέσεις	αντιπαραθεση
αντιπαρατεθούν	αντιπαραθετω
αντιπολίτευση	αντιπολιτευση
αντιπολίτευσης	αντιπολιτευση
αντιπολίτευση	αντιπολιτευση
αντιπολίτευσης	αντιπολιτευση
αντιπροσωπεία	αντιπροσωπεια
αντιπροσωπείας	αντιπροσωπεια
αντιπροσωπείες	αντιπροσωπεια
αντιπροέδρου	αντιπροεδρος
αντιπρόεδρε	αντιπροεδρος
αντιπρόεδρος	αντιπροεδρος
αντιπροέδρους	αντιπροεδρος
αντιπρόεδρο	αντιπροεδρος
αντιπρόεδροι	αντιπροεδρος
αντιπρόσωπο	αντιπροσωπος
αντιπρόσωπος	αντιπροσωπος
αντιστάθηκε	αντιστεκομαι
αντισταθμίζονται	αντισταθμιζω
αντιστασιακές	αντιστασιακος
αντιστασιακή	αντιστασιακος
αντιστασιακό	αντιστασιακος
αντιστασιακών	αντιστασιακος
αντιστοιχία	αντιστοιχια
αντιστοιχεί	αντιστοιχω
αντιστοιχούν	αντιστοιχω
αντιτίθενται	αντιτιθεμαι
αντιτίθεται	αντιτιθεμαι
αντιτρομοκρατικής	αντιτρομοκρατικος
αντιφρονούντων	αντιφρονων
ανυπομονησία	ανυπομονησια
ανύπαρκτες	ανυπαρκτος
ανώμαλες	ανωμαλος
ανώνυμη	ανωνυμος
ανώνυμων	ανωνυμος
ανώτατο	ανωτερος
ανώτατα	ανωτερος
ανώτατες	ανωτερος
ανώτατων	ανωτερος
ανώτερους	ανωτερος
αξία	αξια
αξίας	αξια
αξίες	αξια
αξιών	αξια
αξίζει	αξιζω
αξιώματα	αξιωμα
αξιώματος	αξιωμα
αξιώματός	αξιωμα
αξιώσεις	αξιωση
αξιώσεων	αξιωση
αξιοθέατα	αξιοθεατο
αξιοθέατων	αξιοθεατος
αξιολογήσει	αξιολογω
αξιολογηθεί	αξιολογω
αξιολογούνται	αξιολογω
αξιολόγησε	αξιολογω
αξιολογήσεις	αξιολογηση
αξιολογήσεων	αξιολογηση
αξιολόγησής	αξιολογηση
αξιολόγηση	αξιολογηση
αξιολόγησης	αξιολογηση
αξιοπιστίας	αξιοπιστια
αξιοπρέπειά	αξιοπρεπεια
αξιοσημείωτο	αξιοσημειωτος
αξιοσημείωτα	αξιοσημειωτος
αξιοσημείωτη	αξιοσημειωτος
αξιωματικούς	αξιωματικος
αξιωματικών	αξιωματικος
αξιωματούχοι	αξιωματουχος
αξιωματούχο	αξιωματουχος
αξιωματούχοι	αξιωματουχος
αξιωματούχος	αξιωματουχος
αξιωματούχους	αξιωματουχος
αξιωματούχων	αξιωματουχος
αξιόλογα	αξιολογος
αξιόλογες	αξιολογος
αξιόπιστες	αξιοπιστος
αξιόπιστη	αξιοπιστος
αξιού	αξιος
αξιότιμε	αξιοτιμος
αξιότιμε	αξιοτιμος
αξιότιμοι	αξιοτιμος
αξιότιμος	αξιοτιμος
απήγαγαν	απαγω
απάντησής	απαντηση
απάντηση	απαντηση
απάντησης	απαντηση
απάτες	απατη
απάτη	απατη
απάτης	απατη
απέναντι	απεναντι
απέχει	απεχω
απαίτηση	απαιτηση
απαιτήσεις	απαιτηση
απαιτήσεων	απαιτηση
απαγορευθεί	απαγορευω
απαγορεύει	απαγορευω
απαγορεύουμε	απαγορευω
απαγορεύσει	απαγορευω
απαγορεύτηκε	απαγορευω
απαγωγές	απαγωγη
απαγωγές	απαγωγη
απαγωγής	απαγωγη
απαγόρευση	απαγορευση
αποθανάτισε	απαθανατιζω
απαιτείται	απαιτω
απαίτησαν	απαιτω
απαίτησε	απαιτω
απαιτεί	απαιτω
απαιτείται	απαιτω
απαιτηθεί	απαιτω
απαιτούμε	απαιτω
απαιτούν	απαιτω
απαλλάσσει	απαλλασσω
απαλλαγής	απαλλαγη
απαντώντας	απαντω
απάντησαν	απαντω
απάντησε	απαντω
απαντήσουμε	απαντω
απαντήσω	απαντω
απανωτά	απανωτος
απαξίωση	απαξιωση
απαράδεκτα	απαραδεκτα
απαράδεκτες	απαραδεκτος
απαράδεκτη	απαραδεκτος
απαράδεκτο	απαραδεκτος
απαρέγκλιτη	απαρεγκλιτος
απαραίτητα	απαραιτητος
απαραίτητες	απαραιτητος
απαραίτητη	απαραιτητος
απαραίτητο	απαραιτητος
απαραίτητους	απαραιτητος
απαραίτητων	απαραιτητος
απαρτίζεται	απαρτιζω
απαρτχάιντ	απαρτχαιντ
απαρτχάιντ	απαρτχαιντ
απηρχαιωμένο	απαρχαιωμενος
απασχολημένες	απασχολημενος
απασχολεί	απασχολω
απασχολεί	απασχολω
απασχολούν	απασχολω
απασχολούνται	απασχολω
απασχόλησε	απασχολω
απασχόληση	απασχοληση
απασχόλησης	απασχοληση
απασχόληση	απασχοληση
απασχόλησης	απασχοληση
απεικόνιση	απεικονιση
απειλή	απειλη
απειλών	απειλη
απειλούμενα	απειλουμενος
απείλησαν	απειλω
απειλεί	απειλω
απειλούσε	απειλω
απελάθηκε	απελαυνω
απελευθέρωση	απελευθερωση
απελευθερωτικός	απελευθερωτικος
απελευθερωτικό	απελευθερωτικος
απελευθερώθηκαν	απελευθερωνω
απελπισμένους	απελπισμενος
απερίγραπτη	απεριγραπτος
απεργία	απεργια
απεριόριστη	απεριοριστος
απεσταλμένο	απεσταλμενος
απευθείας	απευθειας
απευθύνεται	απευθυνω
απευθύνεται	απευθυνω
απευθύνετε	απευθυνω
απευθύνθηκαν	απευθυνω
απευθύνομαι	απευθυνω
απευθύνουμε	απευθυνω
απευθύνω	απευθυνω
απλά	απλα
απλώς	απλα
απλοποιήσει	απλοποιω
απλουστευτικές	απλουστευτικος
απλούστευση	απλουστευση
απλές	απλος
απλή	απλος
απλούς	απλος
απλό	απλος
απλώνεται	απλωνω
αποβάθρα	αποβαθρα
αποβαίνει	αποβαινω
αποβεί	αποβαινω
αποβιβαστεί	αποβιβαζω
απεβίωσε	αποβιωνω
απεβίωσε	αποβιωνω
αποβολής	αποβολη
απογοήτευση	απογοητευση
αποδέχομαι	αποδεχομαι
αποδεχθεί	αποδεχομαι
αποδεχθούμε	αποδεχομαι
αποδεχτεί	αποδεχομαι
αποδίδει	αποδιδω
αποδίδονται	αποδιδω
αποδοθεί	αποδιδω
αποδοθούν	αποδιδω
αποδόθηκε	αποδιδω
απέδειξε	αποδεικνυω
αποδείξει	αποδεικνυω
αποδείχθηκαν	αποδεικνυω
αποδείχθηκε	αποδεικνυω
αποδεδειγμένων	αποδεικνυω
αποδεικνύει	αποδεικνυω
αποδεικνύεται	αποδεικνυω
αποδειχθεί	αποδεικνυω
αποδεκτές	αποδεκτος
αποδεκτή	αποδεκτος
αποδεκτό	αποδεκτος
αποδεσμεύσει	αποδεσμευω
αποδημητικά	αποδημητικος
απέδρασαν	αποδιδρω
αποδοκιμάσουν	αποδοκιμαζω
αποδοχή	αποδοχη
αποδοχής	αποδοχη
απέδρασαν	αποδρω
αποδράσουν	αποδρω
αποδυναμώνει	αποδυναμωνω
αποζημιώσεις	αποζημιωση
αποικίες	αποικια
αποικισμό	αποικισμος
αποικήθηκε	αποικω
αποκέντρωση	αποκεντρωση
αποκαταστάθηκαν	αποκαθιστω
αποκαταστήσει	αποκαθιστω
αποκαταστήσουμε	αποκαθιστω
αποκαταστήσουν	αποκαθιστω
αποκατασταθεί	αποκαθιστω
αποκαλούμενη	αποκαλουμενος
αποκάλυψε	αποκαλυπτω
αποκάλυψε	αποκαλυπτω
αποκαλύπτει	αποκαλυπτω
αποκαλύφθηκε	αποκαλυπτω
αποκάλεσε	αποκαλω
αποκαλούμε	αποκαλω
αποκαλούν	αποκαλω
αποκατάσταση	αποκατασταση
αποκεντρωμένα	αποκεντρωνω
αποκεντρωμένο	αποκεντρωνω
απέκλεισε	αποκλειω
αποκλείει	αποκλειω
αποκλείονται	αποκλειω
αποκλείονταν	αποκλειω
αποκλειστικά	αποκλειστικα
αποκλειστική	αποκλειστικος
αποκλειστικό	αποκλειστικος
αποκλειστικός	αποκλειστικος
αποκλειστικών	αποκλειστικος
αποκοίμισαν	αποκοιμιζω
αποκοιμήθηκαν	αποκοιμιεμαι
απέκρουσε	αποκρουω
απέκτησαν	αποκτω
απέκτησε	αποκτω
αποκτά	αποκτω
αποκτήσει	αποκτω
αποκτήσουμε	αποκτω
αποκτήσουν	αποκτω
αποκτούν	αποκτω
αποκτούσαμε	αποκτω
αποκτούσε	αποκτω
αποκτώντας	αποκτω
απολαύσατε	απολαμβανω
απολαύσει	απολαμβανω
απολαύουν	απολαυω
απολλωνία	απολλωνια
απολογία	απολογια
απολογίας	απολογια
απολογισμό	απολογισμος
απολογούνταν	απολογουμαι
απολύθηκε	απολυω
απομάκρυνση	απομακρυνση
απομακρυνθεί	απομακρυνω
απομακρυνθούμε	απομακρυνω
απομακρύνει	απομακρυνω
απομακρύνεται	απομακρυνω
απομακρύνουν	απομακρυνω
απομόνωση	απομονωση
αποξένωση	αποξενωση
αποπληρωμής	αποπληρωμη
αποποίηση	αποποιηση
απορίες	απορια
απέρριψε	απορριπτω
απέρριψε	απορριπτω
απορρίπτουμε	απορριπτω
απορρίφθηκε	απορριπτω
απορρίψει	απορριπτω
απορριφθεί	απορριπτω
απορροφήσει	απορροφω
αποσαφηνιστούν	αποσαφηνιζω
αποσκοπεί	αποσκοπω
αποσκοπεί	αποσκοπω
αποσκοπούν	αποσκοπω
απέστειλε	αποστελλω
αποστείλει	αποστελλω
αποστολές	αποστολη
αποστολή	αποστολη
αποστολής	αποστολη
αποσύνθεσης	αποσυνθεση
απέσυραν	αποσυρω
απέσυρε	αποσυρω
αποσυρθώ	αποσυρω
αποσύρει	αποσυρω
αποσύρεται	αποσυρω
αποσύρουν	αποσυρω
αποτέλεσμα	αποτελεσμα
αποτέλεσμα	αποτελεσμα
αποτελέσματα	αποτελεσμα
αποτελεσμάτων	αποτελεσμα
αποτελεσματικά	αποτελεσματικα
αποτελεσματικές	αποτελεσματικος
αποτελεσματική	αποτελεσματικος
αποτελεσματικό	αποτελεσματικος
αποτελεσματικότερη	αποτελεσματικος
αποτελεσματικότητας	αποτελεσματικοτητα
αποτελεί	αποτελω
αποτέλεσε	αποτελω
αποτελέσει	αποτελω
αποτελέσουν	αποτελω
αποτελεί	αποτελω
αποτελείται	αποτελω
αποτελούν	αποτελω
αποτελούσαν	αποτελω
αποτελούσε	αποτελω
απέτρεπε	αποτρεπω
αποτρέποντας	αποτρεπω
αποτρέψει	αποτρεπω
αποτρέψουν	αποτρεπω
αποτρεπτικές	αποτρεπτικος
αποτυχημένη	αποτυγχανω
αποτυχημένο	αποτυγχανω
αποτύχει	αποτυγχανω
αποτυπωμένο	αποτυπωνω
αποτυχία	αποτυχια
απουσία	απουσια
απουσιάζει	απουσιαζω
αποφέρει	αποφερω
απεφάνθη	αποφαινομαι
αποφάνθηκε	αποφαινομαι
αποφάσισαν	αποφασιζω
αποφάσισε	αποφασιζω
αποφασίζει	αποφασιζω
αποφασίσαμε	αποφασιζω
αποφασίσει	αποφασιζω
αποφασίσετε	αποφασιζω
αποφασίσουμε	αποφασιζω
αποφασίσουν	αποφασιζω
αποφασίστηκαν	αποφασιζω
αποφασιστεί	αποφασιζω
αποφασισμένες	αποφασισμενος
αποφασιστική	αποφασιστικος
αποφασιστικής	αποφασιστικος
αποφασιστικότητά	αποφασιστικοτητα
αποφασιστικότητάς	αποφασιστικοτητα
αποφασιστικότητα	αποφασιστικοτητα
αποφευχθεί	αποφευγω
αποφευχθούν	αποφευγω
αποφεύγουν	αποφευγω
αποφύγουμε	αποφευγω
αποφύγουν	αποφευγω
αποφυγή	αποφυγη
αποχώρησαν	αποχωρω
αποχώρησε	αποχωρω
αποχώρηση	αποχωρηση
απριλίου	απριλιος
απροχώρητο	απροχωρητος
απρόσκοπτη	απροσκοπτος
απτά	απτος
απτό	απτος
απόγευμα	απογευμα
απόδειξη	αποδειξη
αποδόσεις	αποδοση
απόκρημνες	αποκρημνος
απόκτηση	αποκτηση
απόκτησης	αποκτηση
απόλλωνα	απολλωνας
απόλλωνα	απολλωνας
απολύσεις	απολυση
απολύτως	απολυτα
απολύτως	απολυτα
απόλυτα	απολυτα
απόλυτη	απολυτος
απόλυτο	απολυτος
απόλυτους	απολυτος
απόπειρά	αποπειρα
απόπειρα	αποπειρα
απόπειρα	αποπειρα
απόρρητα	απορρητος
απόρρητων	απορρητος
απόρριψη	απορριψη
αποστάσεις	αποσταση
απόστασή	αποσταση
απόσταση	αποσταση
αποστόλου	αποστολος
απόστολο	αποστολος
απόσυρση	αποσυρση
απότακτους	αποτακτος
αποφάσεις	αποφαση
αποφάσεων	αποφαση
απόφαση	αποφαση
απόφασης	αποφαση
απώλεια	απωλεια
απώλειες	απωλεια
απώλειες	απωλεια
αρίλλας	αριλλας
αργότερα	αργα
αργά	αργα
αργότερα	αργα
αργεντινούς	αργεντινος
αργεντινός	αργεντινος
αργοπορημένα	αργοπορω
αργοπορημένη	αργοπορω
αργυρόδετο	αργυροδετο
άργησε	αργω
αριθμητικά	αριθμητικος
αριθμοί	αριθμος
αριθμού	αριθμος
αριθμούς	αριθμος
αριθμό	αριθμος
αριθμός	αριθμος
αριστεράς	αριστερα
αριστερά	αριστερα
αριστοκρατία	αριστοκρατια
αρκάνσας	αρκανσας
αρκετά	αρκετα
αρκετά	αρκετος
αρκετή	αρκετος
αρκετός	αρκετος
αρκεί	αρκω
αρμοδιοτήτων	αρμοδιοτητα
αρμοδιότητα	αρμοδιοτητα
αρμοδιότητες	αρμοδιοτητα
αρμονικά	αρμονικα
αρμόδια	αρμοδιος
αρμόδιες	αρμοδιος
αρμόδιοι	αρμοδιος
αρμόδιος	αρμοδιος
αρνητικά	αρνητικα
αρνητικά	αρνητικος
αρνητικές	αρνητικος
αρνητική	αρνητικος
αρνητικών	αρνητικος
αρνήθηκαν	αρνιεμαι
αρνήθηκε	αρνιεμαι
αρνείται	αρνιεμαι
αρνηθεί	αρνιεμαι
αρνηθούμε	αρνιεμαι
άρπαξαν	αρπαζω
αρρώστιας	αρρωστια
αρτεμίου	αρτεμιος
αρτεμώνας	αρτεμωνας
αρχές	αρχη
αρχή	αρχη
αρχών	αρχη
αρχές	αρχη
αρχή	αρχη
αρχήν	αρχη
αρχής	αρχη
αρχών	αρχη
άρχισαν	αρχιζω
άρχισε	αρχιζω
αρχίζοντας	αρχιζω
άρχισαν	αρχιζω
άρχισε	αρχιζω
αρχίζει	αρχιζω
αρχίζοντας	αρχιζω
αρχίσει	αρχιζω
αρχαίους	αρχαιος
αρχαία	αρχαιος
αρχαίας	αρχαιος
αρχαίο	αρχαιος
αρχαίου	αρχαιος
αρχαίων	αρχαιος
αρχαιολογική	αρχαιολογικος
αρχαιολογικό	αρχαιολογικος
αρχαιολογικό	αρχαιολογικος
αρχαιολογικός	αρχαιολογικος
αρχαιότητα	αρχαιοτητα
αρχηγού	αρχηγος
αρχηγό	αρχηγος
αρχηγών	αρχηγος
αρχικά	αρχικα
αρχικά	αρχικα
αρχικά	αρχικος
αρχικούς	αρχικος
αρχικούς	αρχικος
αρχιτεκτονική	αρχιτεκτονικη
αρχιτεκτονική	αρχιτεκτονικη
αρχιφύλακας	αρχιφυλακας
αρχοντικά	αρχοντικο
αρχοντικά	αρχοντικος
ασία	ασια
ασίας	ασια
ασαφής	ασαφης
ασθένειας	ασθενεια
ασθενείς	ασθενης
ασιάτικη	ασιατικος
ασιατικής	ασιατικος
άσκησαν	ασκω
άσκησε	ασκω
ασκήσει	ασκω
ασκήσουμε	ασκω
ασκεί	ασκω
ασκείται	ασκω
ασκούσε	ασκω
ασπαζόταν	ασπαζομαι
αστείρευτη	αστειρευτος
αστικές	αστικος
αστικού	αστικος
αστυνομία	αστυνομια
αστυνομία	αστυνομια
αστυνομίας	αστυνομια
αστυνομικής	αστυνομικος
αστυνομικοί	αστυνομικος
αστυνομικοί	αστυνομικος
αστυνομικός	αστυνομικος
αστυνομικών	αστυνομικος
αστυνόμευση	αστυνομευση
ασυλία	ασυλια
ασυλίας	ασυλια
ασυνήθιστες	ασυνηθιστος
ασφάλεια	ασφαλεια
ασφάλειας	ασφαλεια
ασφάλειας	ασφαλεια
ασφαλείας	ασφαλεια
ασφάλεια	ασφαλεια
ασφάλειας	ασφαλεια
ασφαλείας	ασφαλεια
ασφάλισης	ασφαλιση
ασφαλή	ασφαλης
ασφαλώς	ασφαλως
ασφαλώς	ασφαλως
ασχολούμαστε	ασχολουμαι
ασχολείται	ασχολουμαι
ασχοληθήκαμε	ασχολουμαι
ασχοληθεί	ασχολουμαι
ασχοληθούμε	ασχολουμαι
ασχοληθώ	ασχολουμαι
ασχολούνται	ασχολουμαι
ατελώς	ατελως
ατζέντα	ατζεντα
ατλέτικο	ατλετικο
ατμοσφαιρική	ατμοσφαιρικος
ατμοσφαιρικής	ατμοσφαιρικος
ατμοσφαιρικό	ατμοσφαιρικος
ατμόσφαιρα	ατμοσφαιρα
ατμόσφαιρας	ατμοσφαιρα
ατμόσφαιρας	ατμοσφαιρα
ατομικά	ατομικα
ατομικής	ατομικος
ατομικά	ατομικος
ατομικές	ατομικος
ατομικών	ατομικος
ατυχήματα	ατυχημα
αυγής	αυγη
αυθόρμητες	αυθορμητος
αυλή	αυλη
αυλές	αυλη
αυξάνεται	αυξανω
αυξάνονται	αυξανω
αυξάνεται	αυξανω
αυξάνονται	αυξανω
αυξάνοντας	αυξανω
αυξάνουν	αυξανω
αυξήθηκε	αυξανω
αυξήσουμε	αυξανω
αυξήσουν	αυξανω
αυξανόταν	αυξανω
αυξηθήκατε	αυξανω
αυξηθεί	αυξανω
αυξηθούν	αυξανω
αυξανόμενο	αυξανομενος
αυξανόμενος	αυξανομενος
αυξημένη	αυξημενος
αυστηρά	αυστηρα
αυστηρότερα	αυστηρα
αυστηρά	αυστηρος
αυστηρή	αυστηρος
αυστηροί	αυστηρος
αυστηρούς	αυστηρος
αυστηρό	αυστηρος
αυστηρότερες	αυστηρος
αυστηρότερων	αυστηρος
αυστηρότητα	αυστηροτητα
αυστηρότητας	αυστηροτητα
αυταρχικής	αυταρχικος
αυτοαπασχολούνται	αυτοαπασχολουμαι
αυτοαπασχολούμενους	αυτοαπασχολουμενος
αυτοαπασχολούμενων	αυτοαπασχολουμενος
αυτοβούλως	αυτοβουλως
αυτοδιάθεσης	αυτοδιαθεση
αυτοδιοίκηση	αυτοδιοικηση
αυτοκίνητα	αυτοκινητο
αυτοκίνητο	αυτοκινητο
αυτοκινήτου	αυτοκινητο
αυτοκινήτου	αυτοκινητο
αυτοκινήτων	αυτοκινητο
αυτοκινητικά	αυτοκινητικος
αυτοκινητιστικού	αυτοκινητιστικος
αυτοκινητοβιομηχανία	αυτοκινητοβιομηχανια
αυτοκινητοπομπή	αυτοκινητοπομπη
αυτοκινητοδρόμους	αυτοκινητοδρομος
αυτοκράτορα	αυτοκρατορας
αυτοκρατορία	αυτοκρατορια
αυτοκρατορίας	αυτοκρατορια
αυτοκρατορία	αυτοκρατορια
αυτοκρατορίας	αυτοκρατορια
αυτοκρατορικής	αυτοκρατορικος
αυτοκτονίες	αυτοκτονια
αυτοκτονιών	αυτοκτονια
αυτοκτονεί	αυτοκτονω
αυτοκτονούν	αυτοκτονω
αυτοματοποιημένο	αυτοματοποιημενος
αυτονομία	αυτονομια
αυτονόμηση	αυτονομηση
αυτοσκοπό	αυτοσκοπος
αυτοσυγκράτηση	αυτοσυγκρατηση
αυτόματα	αυτοματα
αυτόματες	αυτοματος
αυτόματης	αυτοματος
αυτόνομο	αυτονομος
αυτόπτες	αυτοπτης
αυτόχειρες	αυτοχειρας
αφέθηκαν	αφηνω
άφησε	αφηνω
αφέθηκαν	αφηνω
αφέθηκε	αφηνω
αφήνει	αφηνω
αφήνοντας	αφηνω
αφήσαμε	αφηνω
αφήσει	αφηνω
αφήσουν	αφηνω
αφαίρεσαν	αφαιρω
αφαιρέθηκε	αφαιρω
αφαιρέσει	αφαιρω
αφαιρέσετε	αφαιρω
αφαιρεί	αφαιρω
αφγανικός	αφγανικος
αφγανιστάν	αφγανισταν
αφγανοί	αφγανος
αφενός	αφενος
αφενός	αφενος
αφετέρου	αφετερου
αφετέρου	αφετερου
αφετηρία	αφετηρια
αφηρημένα	αφηρημενα
αφιερώσαμε	αφιερωνω
αφιερωθεί	αφιερωνω
αφιερωμένη	αφιερωνω
αφομοίωση	αφομοιωση
αφοπλισμού	αφοπλισμος
αφοπλισμό	αφοπλισμος
αφόρισε	αφοριζω
αφορμή	αφορμη
αφορά	αφορω
αφορούν	αφορω
αφρικανικές	αφρικανικος
αφρικανική	αφρικανικος
αφρική	αφρικη
αφρικής	αφρικη
αχερουσίας	αχερουσια
αυξήσεις	αυξηση
αύξηση	αυξηση
αύξησης	αυξηση
αύριο	αυριο
βαδίσματος	βαδισμα
βαδίσματος	βαδισμα
βάλει	βαζω
βάθος	βαθος
βάλερι	βαλερι
βάρκα	βαρκα
βάρος	βαρος
βάσει	βασει
βάσεις	βαση
βάσεων	βαση
βάση	βαση
βάσης	βαση
βάσιμες	βασιμος
βάττεμβεργ	βαττεμβεργ
βέβαια	βεβαια
βέβαια	βεβαια
βεβαίως	βεβαια
βέβαιο	βεβαιος
βέβαιος	βεβαιος
βεβαία	βεβαιος
βέλτιστα	βελτιστος
βέλτιστο	βελτιστος
βέτο	βετο
βήμα	βημα
βήματα	βημα
βία	βια
βίας	βια
βίαιων	βιαιος
βίβλο	βιβλος
βίβλος	βιβλος
βίδο	βιδο
βίδο	βιδο
βίδρες	βιδρα
βίζα	βιζα
βίντεο	βιντεο
βίου	βιος
βαγή	βαγης
βαθμιαίο	βαθμιαιος
βαθμό	βαθμος
βαθμών	βαθμος
βαθιάς	βαθυς
βαθύτερη	βαθυς
βαλεαρίδων	βαλεαριδες
βαλκανικής	βαλκανικη
βαλκανικοί	βαλκανικος
βαλκανικοί	βαλκανικος
βαπτιστήριο	βαπτιστηριο
βαρύνει	βαραινω
βαρύνουν	βαραινω
βαρβαρικές	βαρβαρικος
βαρόμετρο	βαρομετρο
βαρύ	βαρυς
βασίζεται	βασιζω
βασίσει	βασιζω
βασίστηκε	βασιζω
βασισμένες	βασιζω
βασισμένη	βασιζω
βασίλειο	βασιλειο
βασιλείου	βασιλειο
βασίλεια	βασιλειο
βασίλειό	βασιλειο
βασίλειο	βασιλειος
βασιλείου	βασιλειος
βασίλισσας	βασιλισσα
βασανίζουν	βασανιζω
βασιζόμενο	βασιζομενος
βασικά	βασικα
βασικά	βασικος
βασικές	βασικος
βασικής	βασικος
βασικό	βασικος
βασιλέα	βασιλεας
βασιλείας	βασιλεια
βασιλιά	βασιλιας
βασιλιά	βασιλιας
βασιλιάς	βασιλιας
βασιλικές	βασιλικη
βασιλικής	βασιλικος
βασιλομήτωρ	βασιλομητωρ
βατερλό	βατερλο
έβγαλαν	βγαζω
βγει	βγαινω
βεατρίκη	βεατρικη
βεβαίωση	βεβαιωση
βεβαίωσης	βεβαιωση
βεβαιώσεων	βεβαιωση
βεβαιότητα	βεβαιοτητα
βεβιασμένη	βεβιασμενος
βελγικά	βελγικος
βελγική	βελγικος
βελγικών	βελγικος
βεληνεκούς	βεληνεκες
βελτίωση	βελτιωση
βελτίωσης	βελτιωση
βελτιώσεις	βελτιωση
βελτιώνεται	βελτιωνω
βελτίωσαν	βελτιωνω
βελτιωθεί	βελτιωνω
βελτιωθούν	βελτιωνω
βελτιώνει	βελτιωνω
βελτιώνεται	βελτιωνω
βελτιώσει	βελτιωνω
βελτιώσουμε	βελτιωνω
βενετσιάνικα	βενετσιανικος
βενζολίου	βενζολιο
βενιαμίν	βενιαμιν
βενιζέλο	βενιζελος
βενιζέλος	βενιζελος
βενιζέλου	βενιζελος
βερνίκια	βερνικι
βερσαλλιών	βερσαλλιες
βιέννης	βιενη
βιβλίο	βιβλιο
βιβλική	βιβλικος
βιολογικά	βιολογικος
βιολογικής	βιολογικος
βιολογικών	βιολογικος
βιομηχανίας	βιομηχανια
βιομηχανιών	βιομηχανια
βιομηχανικής	βιομηχανικος
βιομηχανικά	βιομηχανικος
βιοτεχνίες	βιοτεχνια
βιοτικού	βιοτικος
βιότοπος	βιοτοπος
βιώσιμη	βιωσιμος
βιώσιμης	βιωσιμος
βλάβες	βλαβη
έβλαπτε	βλαπτω
βλάστηση	βλαστηση
δείτε	βλεπω
βλέπουμε	βλεπω
δείτε	βλεπω
δει	βλεπω
δούμε	βλεπω
είδαμε	βλεπω
είδαν	βλεπω
είδατε	βλεπω
βλέψεις	βλεψη
βλακώδες	βλακωδης
βλαντιμίρ	βλαντιμιρ
βοήθεια	βοηθεια
βοήθειας	βοηθεια
βοηθούς	βοηθος
βοήθησαν	βοηθω
βοηθήσει	βοηθω
βοηθήσουμε	βοηθω
βοηθήσουν	βοηθω
βοηθούν	βοηθω
βομβαρδισμοί	βομβαρδισμος
βομβαρδισμού	βομβαρδισμος
βομβαρδισμός	βομβαρδισμος
βοναπάρτης	βοναπαρτης
βορειοανατολική	βορειοανατολικος
βορειοανατολικών	βορειοανατολικος
βορειοκορεατικά	βορειοκορεατικος
βορρά	βορρας
βορρά	βορρας
βουλή	βουλη
βουλής	βουλη
βουλγαρική	βουλγαρικος
βουλγαρικής	βουλγαρικος
βουλγαρίας	βουλγαρια
βουλευτές	βουλευτης
βουλευτή	βουλευτης
βουλευτής	βουλευτης
βουλευτού	βουλευτης
βουλευτών	βουλευτης
βουλευτικές	βουλευτικος
βουλευτική	βουλευτικος
βουλευτικής	βουλευτικος
βουλευτικών	βουλευτικος
βουλφ	βουλφ
βουνοκορυφές	βουνοκορυφη
βουνοπλαγιές	βουνοπλαγια
βουνά	βουνο
βουνού	βουνο
βουνών	βουνο
βούλγαροι	βουλγαρος
βούλγαρος	βουλγαρος
βουλεύματα	βουλευμα
βουλήσεων	βουληση
βούλησή	βουληση
βούληση	βουληση
βράδυ	βραδυ
βράχο	βραχος
βράχους	βραχος
βρέφος	βρεφος
βρίσκεται	βρισκω
βρισκόμαστε	βρισκω
βρέθηκαν	βρισκω
βρέθηκε	βρισκω
βρήκαν	βρισκω
βρήκε	βρισκω
βρίσκει	βρισκω
βρίσκεται	βρισκω
βρίσκονται	βρισκω
βρίσκονταν	βρισκω
βρίσκουν	βρισκω
βρίσκω	βρισκω
βρεί	βρισκω
βρεθεί	βρισκω
βρεθείτε	βρισκω
βρεθούν	βρισκω
βρισκόμαστε	βρισκω
βρισκόταν	βρισκω
βρούμε	βρισκω
βραζιλιάνος	βραζιλιανος
βραχονησίδες	βραχονησιδα
βραχυπρόθεσμης	βραχυπροθεσμος
βραχυπρόθεσμο	βραχυπροθεσμος
βρετανών	βρετανη
βρετανίας	βρετανια
βρετανική	βρετανικος
βρετανικές	βρετανικος
βρετανική	βρετανικος
βρετανικών	βρετανικος
βρετανοί	βρετανος
βρετανούς	βρετανος
βρετανού	βρετανος
βρετανό	βρετανος
βρύσες	βρυση
βυζάντιο	βυζαντιο
βυζαντινοί	βυζαντινος
βυζαντινούς	βυζαντινος
βυζαντινό	βυζαντινος
βυζαντινά	βυζαντινος
βυζαντινού	βυζαντινος
βυζαντινών	βυζαντινος
βυθίστηκε	βυθιζω
βωμό	βωμος
βόλο	βολος
βόρεια	βορεια
βόρεια	βορεια
βορείου	βορειος
βόρεια	βορειος
βόρειας	βορειος
βόρειες	βορειος
βόρειο	βορειος
βόρειων	βορειος
βορειότερο	βορειος
βόρεια	βορειος
βόρειο	βορειος
γάλλοι	γαλλος
γάλλος	γαλλος
γάλλους	γαλλος
γάλλων	γαλλος
γάλλο	γαλλος
γένει	γενει
γέρνει	γερνω
γέφυρα	γεφυρα
γέφυρας	γεφυρα
έγιναν	γινομαι
έγιναν	γινομαι
έγινε	γινομαι
γίνει	γινομαι
γίνεται	γινομαι
γίνονται	γινομαι
γίνονταν	γινομαι
γίνουν	γινομαι
γινόταν	γινομαι
γαλάζιο	γαλαζιος
γαληνότατης	γαληνοτατος
γαλλικά	γαλλικα
γαλλική	γαλλικη
γαλλικής	γαλλικη
γαλλικό	γαλλικος
γαλλικός	γαλλικος
γαλλικές	γαλλικος
γαλλικής	γαλλικος
γαλλικού	γαλλικος
γαλλικό	γαλλικος
γείτονές	γειτονας
γείτονα	γειτονας
γειτόνων	γειτονας
γεγονός	γεγονος
γεγονότα	γεγονος
γεγονότος	γεγονος
γεγονότων	γεγονος
γειτονιά	γειτονια
γειτονιές	γειτονια
γειτονικά	γειτονικος
γειτονικές	γειτονικος
γειτονικού	γειτονικος
γεμάτο	γεματος
γέμισαν	γεμιζω
γεμίζουν	γεμιζω
γενετικό	γενετικος
γενεύη	γενευη
γενιές	γενια
γενικά	γενικα
γενικότερα	γενικα
γενικευμένη	γενικευω
γενική	γενικος
γενικής	γενικος
γενικού	γενικος
γενικός	γενικος
γενικών	γενικος
γενικά	γενικος
γενική	γενικος
γενικής	γενικος
γενικού	γενικος
γενικό	γενικος
γενικότερη	γενικος
γενικών	γενικος
γεννήθηκε	γεννω
γεννά	γεννω
γεννήθηκαν	γεννω
γεράκι	γερακι
γερακίνες	γερακινα
γερμανία	γερμανια
γερμανίας	γερμανια
γερμανική	γερμανικη
γερμανικής	γερμανικη
γερμανικού	γερμανικος
γερμανικά	γερμανικος
γερμανική	γερμανικος
γερμανικής	γερμανικος
γερμανικών	γερμανικος
γερμανοί	γερμανος
γερμανούς	γερμανος
γερμανούς	γερμανος
γερμανόφιλο	γερμανοφιλος
γερμανόφωνων	γερμανοφωνος
γερουσιαστές	γερουσιαστης
γεφυρώσει	γεφυρωνω
γεφυρώσουμε	γεφυρωνω
γεφύρια	γεφυρι
γεωγραφική	γεωγραφικος
γεωργία	γεωργια
γεωργιάδης	γεωργιαδης
γεωργικές	γεωργικος
γεωργίου	γεωργιος
γεώργιος	γεωργιος
γη	γη
γης	γη
γης	γη
γηγενείς	γηγενης
γηγενών	γηγενης
γιάννη	γιαννης
γιάννης	γιαννης
γιάννης	γιαννης
γιατί	γιατι
γιατροί	γιατρος
γιατρούς	γιατρος
γιατρών	γιατρος
γιγαντιαίο	γιγαντιαιος
γιορτάζουμε	γιορταζω
γιος	γιος
γιου	γιος
γιουγκοσλαβία	γιουγκοσλαβια
γιουγκοσλαβίας	γιουγκοσλαβια
γιουγκοσλαβική	γιουγκοσλαβικος
γιουγκοσλαβικής	γιουγκοσλαβικος
γιουνάιτεντ	γιουναιτεντ
γιουρόπα	γιουροπα
γιούρων	γιουρα
γιό	γιο
γιός	γιος
γιόσιπ	γιοσιπ
γιώργο	γιωργος
γκίνγκρις	γκινγκρις
γκίνγκριτζ	γκινγκριτζ
γκίνγκριτς	γκινγκριτς
γκανόν	γκανον
γκατίλοφ	γκατιλοφ
γκεβάρα	γκεβαρα
γκενάντι	γκεναντι
γκι	γκι
γκιάντ	γκιαντ
γκιουνές	γκιουνες
γκολ	γκολ
γκούλαγκ	γκουλαγκ
γκρεμισμένα	γκρεμιζω
γκρεμού	γκρεμος
γκρεμό	γκρεμος
γκρεμός	γκρεμος
γλαύκος	γλαυκος
γλιτώσουν	γλιτωνω
γλυπτά	γλυπτος
γλωσσικούς	γλωσσικος
γλωσσών	γλωσσα
γλώσσας	γλωσσα
γνήσιες	γνησιος
γνωμοδοτήσεις	γνωμοδοτηση
γνωμοδοτήσεων	γνωμοδοτηση
γνωμοδότησή	γνωμοδοτηση
γνωρίζει	γνωριζω
γνωρίζετε	γνωριζω
γνωρίζουμε	γνωριζω
γνωρίζω	γνωριζω
γνωρίζει	γνωριζω
γνωρίζετε	γνωριζω
γνωρίζουμε	γνωριζω
γνωρίζω	γνωριζω
γνωρίσει	γνωριζω
γνωστά	γνωστος
γνωστή	γνωστος
γνωστή	γνωστος
γνωστό	γνωστος
γνωστόν	γνωστος
γνωστός	γνωστος
γνώμη	γνωμη
γνώμης	γνωμη
γνώρισμα	γνωρισμα
γνώσει	γνωσει
γνώσεων	γνωση
γνώση	γνωση
γνώσης	γνωση
γοητευτικά	γοητευτικος
γοητευτικό	γοητευτικος
γονέων	γονεων
γουέν	γουεν
γουλιέλμος	γουλιελμος
γουόρτσεστερ	γουορτσεστερ
γούστερ	γουστερ
γράμμα	γραμμα
έγραφε	γραφω
γράφονται	γραφω
γρήγορα	γρηγορα
γρήγορα	γρηγορα
γρήγορες	γρηγορος
γρίπη	γριπη
γρίπης	γριπη
γραμμές	γραμμη
γραμμή	γραμμη
γραμμής	γραμμη
γραμματέα	γραμματεας
γραμματέας	γραμματεας
γραμματοσήμων	γραμματοσημο
γραπτές	γραπτος
γραπτή	γραπτος
γραφείου	γραφειο
γραφεία	γραφειο
γραφείο	γραφειο
γραφείου	γραφειο
γραφείων	γραφειο
γραφειοκρατία	γραφειοκρατια
γραφειοκρατικά	γραφειοκρατικος
γραφειοκρατικές	γραφειοκρατικος
γραφειοκρατικής	γραφειοκρατικος
γραφειοκρατικό	γραφειοκρατικος
γραφειοκρατικών	γραφειοκρατικος
γραφικά	γραφικος
γραφικό	γραφικος
γραφικών	γραφικος
γρηγορίου	γρηγοριος
γρηγόριος	γρηγοριος
γρυπάρη	γρυπαρης
γυμνάσια	γυμνασιο
γυναίκα	γυναικα
γυναίκες	γυναικα
γυναικών	γυναικα
γυρίσαμε	γυριζω
γυρίσει	γυριζω
γύρισε	γυριζω
γύρος	γυρος
γύρους	γυρος
γύρω	γυρω
δάσκαλος	δασκαλος
δάση	δασος
δάσος	δασος
δέκατη	δεκατος
δέκατης	δεκατος
δέλτα	δελτα
δεμάτων	δεμα
δέντρα	δεντρο
δέσμευσή	δεσμευση
δέσμευση	δεσμευση
δέσμευσης	δεσμευση
δεσμεύσεις	δεσμευση
δεσμεύσεων	δεσμευση
δέσμη	δεσμη
δέσμης	δεσμη
δέχεται	δεχομαι
δέχθηκε	δεχομαι
δέχονται	δεχομαι
δέχτηκε	δεχομαι
δεχθεί	δεχομαι
δεχθούμε	δεχομαι
δεχθούν	δεχομαι
δεχτούμε	δεχομαι
δεχόμαστε	δεχομαι
δήλωση	δηλωση
δήλωσης	δηλωση
δηλώσεις	δηλωση
δήμο	δημος
δήμος	δημος
δήμου	δημος
δήμο	δημος
δήμου	δημος
δήμους	δημος
δήμων	δημος
δίκαια	δικαιο
δίκαιο	δικαιο
δίκαιο	δικαιο
δικαίου	δικαιο
δίκη	δικη
δίκη	δικη
δίκης	δικη
δίκιο	δικιο
δίκτυο	δικτυο
δίκτυα	δικτυο
δίκτυο	δικτυο
δίκτυό	δικτυο
δικτύου	δικτυο
δίλημμα	διλημμα
δίμηνη	διμηνος
δεδομένης	δινω
έδιναν	δινω
έδωσα	δινω
έδωσαν	δινω
έδωσε	δινω
δίνει	δινω
δίνεται	δινω
δίνοντας	δινω
δίνουμε	δινω
δίνουν	δινω
δίνω	δινω
δοθεί	δινω
δοθούν	δινω
δόθηκε	δινω
δώσαμε	δινω
δώσει	δινω
δώσουμε	δινω
δώσω	δινω
δίπλα	διπλα
δίπλωμα	διπλωμα
διπλωμάτων	διπλωμα
δίσκοι	δισκος
δίωξης	διωξη
διώξεις	διωξη
δαγκλή	δαγκλη
δαλάι	δαλαι
δανείζεται	δανειζω
δαπάνες	δαπανη
δαπανών	δαπανη
δαπανήσει	δαπανω
δασικό	δασικος
δε	δε
δείγματα	δειγμα
δείκτες	δεικτης
δείκτης	δεικτης
έδειξαν	δειχνω
έδειξε	δειχνω
έδειχνε	δειχνω
δείξει	δειχνω
δείχνει	δειχνω
δείχνουν	δειχνω
δεδομένο	δεδομενο
δεδομένου	δεδομενο
δεδομένων	δεδομενο
δεδουλευμένων	δεδουλευμενος
δεκέμβρη	δεκεμβριος
δεκέμβριο	δεκεμβριος
δεκεμβρίου	δεκεμβριος
δεκαετούς	δεκαετης
δεκαετία	δεκαετια
δεκαετίας	δεκαετια
δεκαετίες	δεκαετια
δεκεμβριανά	δεκεμβριανος
δεκεμβριανών	δεκεμβριανος
δεκτές	δεκτος
δεκτή	δεκτος
δεκτό	δεκτος
δελχί	δελχι
δεξαμενές	δεξαμενη
δεξιάς	δεξιος
δεξιόστροφη	δεξιοστροφος
δεσμευτικά	δεσμευτικος
δεσμεύομαι	δεσμευω
δεσμεύτηκε	δεσμευω
δεσμοφύλακας	δεσμοφυλακας
δεσμοφύλακες	δεσμοφυλακας
δεσμούς	δεσμος
δευτέρα	δευτερα
δευτερεύοντα	δευτερευων
δευτεροβάθμια	δευτεροβαθμιος
δευτερόλεπτα	δευτερολεπτο
δεύτερον	δευτερος
δευτέρου	δευτερος
δεύτερον	δευτερος
δηλαδή	δηλαδη
δηλαδή	δηλαδη
δηλιγιάννη	δηλιγιαννης
δηλώσαμε	δηλωνω
δήλωναν	δηλωνω
δήλωνε	δηλωνω
δήλωσα	δηλωνω
δήλωσαν	δηλωνω
δήλωσε	δηλωνω
δηλώθηκε	δηλωνω
δηλώνει	δηλωνω
δηλώνοντας	δηλωνω
δηλώνουν	δηλωνω
δηλώνω	δηλωνω
δηλώσει	δηλωνω
δηλώσω	δηλωνω
δημήτριος	δημητριος
δημιουργία	δημιουργια
δημιουργίας	δημιουργια
δημιουργήθηκαν	δημιουργω
δημιουργήθηκε	δημιουργω
δημιουργήσαμε	δημιουργω
δημιουργήσει	δημιουργω
δημιουργήσουμε	δημιουργω
δημιουργήσουν	δημιουργω
δημιουργείται	δημιουργω
δημιουργηθεί	δημιουργω
δημιουργούν	δημιουργω
δημιούργησαν	δημιουργω
δημιούργησε	δημιουργω
δημιούργημα	δημιουργημα
δημοκρατία	δημοκρατια
δημοκρατίας	δημοκρατια
δημοκρατία	δημοκρατια
δημοκρατίας	δημοκρατια
δημοκρατίες	δημοκρατια
δημοκρατικά	δημοκρατικα
δημοκρατικά	δημοκρατικα
δημοκρατικοί	δημοκρατικος
δημοκρατικούς	δημοκρατικος
δημοκρατικών	δημοκρατικος
δημοκρατικά	δημοκρατικος
δημοκρατικές	δημοκρατικος
δημοκρατική	δημοκρατικος
δημοκρατικής	δημοκρατικος
δημοκρατικού	δημοκρατικος
δημοκρατικό	δημοκρατικος
δημοσιεύματα	δημοσιευμα
δημοσιευθεί	δημοσιευω
δημοσιογράφοι	δημοσιογραφος
δημοσιογράφων	δημοσιογραφος
δημοσιογράφο	δημοσιογραφος
δημοσιογράφοι	δημοσιογραφος
δημοσιογράφος	δημοσιογραφος
δημοσιογράφου	δημοσιογραφος
δημοσιογράφων	δημοσιογραφος
δημοσιονομική	δημοσιονομικος
δημοσιονομικής	δημοσιονομικος
δημοσιονομικού	δημοσιονομικος
δημοσιονομικό	δημοσιονομικος
δημοσιονομικός	δημοσιονομικος
δημοσιονομικών	δημοσιονομικος
δημοσιοποίησαν	δημοσιοποιω
δημοσιοποίησε	δημοσιοποιω
δημοσιοποιήθηκε	δημοσιοποιω
δημοσιότητα	δημοσιοτητα
δημοσκοπήσεις	δημοσκοπηση
δημοτικό	δημοτικος
δημοτικότητα	δημοτικοτητα
δημοφιλή	δημοφιλης
δημοφιλής	δημοφιλης
δημοψήφισμα	δημοψηφισμα
δημοψηφίσματα	δημοψηφισμα
δημοσίου	δημοσιος
δημοσίων	δημοσιος
δημόσιας	δημοσιος
δημοσίου	δημοσιος
δημοσίου	δημοσιος
δημοσίων	δημοσιος
δημόσια	δημοσιος
δημόσιας	δημοσιος
δημόσιες	δημοσιος
δημόσιο	δημοσιος
δημόσιων	δημοσιος
διάβα	διαβα
διαβήματα	διαβημα
διαβόλους	διαβολος
διάδοση	διαδοση
διάδοχός	διαδοχος
διαδόχους	διαδοχος
διάθεσή	διαθεση
διάθεση	διαθεση
διάθεσης	διαθεση
διάκριση	διακριση
διακρίσεις	διακριση
διακρίσεων	διακριση
διάλογο	διαλογος
διάλογος	διαλογος
διαλόγου	διαλογος
διάλυση	διαλυση
διάρκεια	διαρκεια
διάρκειας	διαρκεια
διάσκεψη	διασκεψη
διάσκεψη	διασκεψη
διάσπαρτα	διασπαρτος
διάσταση	διασταση
διάστημα	διαστημα
διαστήματα	διαστημα
διάσωση	διασωση
διάσωσης	διασωση
διάταξη	διαταξη
διατάξεις	διαταξη
διατάξεων	διαταξη
διάφορα	διαφορος
διάφορες	διαφορος
διάφορους	διαφορος
διαφόρων	διαφορος
διάχυτη	διαχυτος
διέρχεται	διερχομαι
διίστανται	διισταμαι
διαβάζοντας	διαβαζω
διαβίβασε	διαβιβαζω
διαβιβάστηκε	διαβιβαζω
διαβιβαστεί	διαβιβαζω
διαβιβαστικές	διαβιβαστικος
διαβλέποντας	διαβλεπω
διαβουλευθούμε	διαβουλευω
διαβουλεύσεις	διαβουλευση
διαβούλευση	διαβουλευση
διαβούλευσης	διαβουλευση
διαγραφής	διαγραφη
διαγωγή	διαγωγη
διαγωγής	διαγωγη
διαγωνισμού	διαγωνισμος
διαγωνισμούς	διαγωνισμος
διαγωνισμό	διαγωνισμος
διαδέχθηκε	διαδεχομαι
διαδεχθεί	διαδεχομαι
διαδήλωση	διαδηλωση
διαδήλωσης	διαδηλωση
διαδηλώσεις	διαδηλωση
διαδηλώσεων	διαδηλωση
διαδίκτυο	διαδικτυο
διαδίκτυο	διαδικτυο
διαδικτύου	διαδικτυο
διαδηλωτές	διαδηλωτης
διαδηλωτών	διαδηλωτης
διαδηλώνουν	διαδηλωνω
διαδικασία	διαδικασια
διαδικασίας	διαδικασια
διαδικασίες	διαδικασια
διαδικασιών	διαδικασια
διαδραμάτισε	διαδραματιζω
διαδραματίζει	διαδραματιζω
διαδραματίζεται	διαδραματιζω
διαδραματίζοντας	διαδραματιζω
διαδραματίσει	διαδραματιζω
διαδρομή	διαδρομη
διαδρομών	διαδρομη
διαθέσιμων	διαθεσιμος
διέθεταν	διαθετω
διέθετε	διαθετω
διαθέτει	διαθετω
διαθέτουμε	διαθετω
διαθέτουν	διαθετω
διατέθηκαν	διαθετω
διατίθενται	διαθετω
διατεθειμένη	διαθετω
διατεθειμένοι	διαθετω
διατεθούν	διαθετω
διαθεσιμότητας	διαθεσιμοτητα
διακήρυξη	διακηρυξη
διακήρυξή	διακηρυξη
διακήρυξη	διακηρυξη
διακίνηση	διακινηση
διακίνησης	διακινηση
διακανονισμού	διακανονισμος
διακήρυσσαν	διακηρυσσω
διακηρύξει	διακηρυσσω
διακηρύσσει	διακηρυσσω
διακινδυνεύουμε	διακινδυνευω
διακινδυνεύσουν	διακινδυνευω
διακοίνωση	διακοινωση
διακοπών	διακοπη
διέκρινα	διακρινω
διακρίνουμε	διακρινω
διακρατική	διακρατικος
διακρατικής	διακρατικος
διακριτική	διακριτικος
διακριτικότητα	διακριτικοτητα
διακυβέρνηση	διακυβερνηση
διακυβερνητική	διακυβερνητικος
διακυβερνητική	διακυβερνητικος
διακυβερνητικής	διακυβερνητικος
διέκοψε	διακοπτω
διακοπεί	διακοπτω
διακόπτοντας	διακοπτω
διεκόπη	διακοπτω
διαλέγει	διαλεγω
διαλυτικά	διαλυτικο
διαλύεται	διαλυω
διαμάχη	διαμαχη
διαμέρισμα	διαμερισμα
διαμαρτυρία	διαμαρτυρια
διαμαρτυρίας	διαμαρτυρια
διαμαρτυρίας	διαμαρτυρια
διαμαρτυρείται	διαμαρτυρω
διαμαρτυρήθηκαν	διαμαρτυρομαι
διαμαρτυρηθεί	διαμαρτυρομαι
διαμονή	διαμονη
διαμορφωμένα	διαμορφωνω
διαμορφώνεται	διαμορφωνω
διαμορφώνουμε	διαμορφωνω
διαμόρφωσε	διαμορφωνω
διανέμονται	διανεμω
διανομή	διανομη
διανομής	διανομη
διανύουμε	διανυω
διανύσετε	διανυω
διαπίστευση	διαπιστευση
διαπίστωση	διαπιστωση
διαπιστευτήρια	διαπιστευτηριο
διαπιστώνεται	διαπιστωνω
διαπίστωσε	διαπιστωνω
διαπιστώνει	διαπιστωνω
διαπιστώνουμε	διαπιστωνω
διαπιστώνουν	διαπιστωνω
διαπιστώνω	διαπιστωνω
διαπιστώσαμε	διαπιστωνω
διαπιστώσει	διαπιστωνω
διέπνεε	διαπνεω
διαπράξει	διαπραττω
διαπράττονται	διαπραττω
διαπραγματεύσεις	διαπραγματευση
διαπραγματεύσεων	διαπραγματευση
διαπραγματευτεί	διαπραγματευομαι
διήρκεσε	διαρκω
διήρκησε	διαρκω
διαρκέσει	διαρκω
διαρκώς	διαρκως
διαρρέει	διαρρεω
διαρρέουν	διαρρεω
διαρροών	διαρροη
διασημότητες	διασημοτητα
διασποράς	διασπορα
διασυνδέει	διασυνδεω
διασυνοριακή	διασυνοριακος
διασυνοριακών	διασυνοριακος
διασφάλιση	διασφαλιση
διασφάλιζε	διασφαλιζω
διασφαλίζει	διασφαλιζω
διασφαλίζεται	διασφαλιζω
διασφαλίσει	διασφαλιζω
διασφαλίσουμε	διασφαλιζω
διασφαλίσουν	διασφαλιζω
διασφαλιστεί	διασφαλιζω
διασχίζει	διασχιζω
διασχίζονταν	διασχιζω
διασχίζοντας	διασχιζω
διασωστικές	διασωστικος
διασώζονται	διασωζω
διατήρηση	διατηρηση
διαταραχή	διαταραχη
διατεθειμένο	διατεθειμενος
διατηρητέα	διατηρητεος
διατηρήθηκε	διατηρω
διατηρήσετε	διατηρω
διατηρήσουμε	διατηρω
διατηρεί	διατηρω
διατηρηθεί	διατηρω
διατηρούν	διατηρω
διατηρώντας	διατηρω
διατρανώνουν	διατρανωνω
διατυπωθεί	διατυπωνω
διατυπωθούν	διατυπωνω
διατυπώθηκαν	διατυπωνω
διατυπώνει	διατυπωνω
διατυπώνονται	διατυπωνω
διατυπώσω	διατυπωνω
διατύπωσα	διατυπωνω
διατύπωση	διατυπωση
διαφάνειας	διαφανεια
διαφέρει	διαφερω
διαφέρουν	διαφερω
διαφανή	διαφανης
διαφανής	διαφανης
διέφυγε	διαφευγω
διαφύγει	διαφευγω
διαφθοράς	διαφθορα
διαφιλονικούμενη	διαφιλονικουμενος
διαφορά	διαφορα
διαφορές	διαφορα
διαφορών	διαφορα
διαφορετικά	διαφορετικα
διαφορετικά	διαφορετικος
διαφορετικές	διαφορετικος
διαφορετική	διαφορετικος
διαφορετικούς	διαφορετικος
διαφορετικών	διαφορετικος
διαφοροποιημένες	διαφοροποιω
διαφυγή	διαφυγη
διαφωνία	διαφωνια
διαφωνίες	διαφωνια
διαφωνούσαν	διαφωνω
διαφώνησαν	διαφωνω
διαχείριση	διαχειριση
διαχείρισης	διαχειριση
διαχώριζαν	διαχωριζω
διαχωρισμού	διαχωρισμος
διαχωρισμό	διαχωρισμος
διαχωρισμός	διαχωρισμος
διδαχθούμε	διδασκω
διδασκόντων	διδασκων
διδασκομένων	διδασκομενος
διείσδυση	διεισδυση
διεθνές	διεθνης
διεθνή	διεθνης
διεθνής	διεθνης
διεθνές	διεθνης
διεθνή	διεθνης
διεθνής	διεθνης
διεθνείς	διεθνης
διεθνούς	διεθνης
διεθνών	διεθνης
διεθνώς	διεθνως
διεκδικεί	διεκδικω
διεκπεραίωση	διεκπεραιωση
διενέργεια	διενεργεια
διεξάγει	διεξαγω
διεξάγεται	διεξαγω
διεξάγονται	διεξαγω
διεξάγουν	διεξαγω
διεξήγαν	διεξαγω
διεξήχθη	διεξαγω
διεξήχθησαν	διεξαγω
διεξαγάγαμε	διεξαγω
διεξαχθεί	διεξαγω
διεξαχθούν	διεξαγω
διεξαγωγή	διεξαγωγη
διεξαγωγής	διεξαγωγη
διερευνήσει	διερευνω
διερεύνηση	διερευνηση
διερεύνησης	διερευνηση
διερχόμενα	διερχομενος
διερχόμενη	διερχομενος
διετή	διετης
διετία	διετια
διευθέτηση	διευθετηση
διευθυντής	διευθυντης
διευθύντρια	διευθυντρια
διευθύντρια	διευθυντρια
διηύθυνε	διευθυνω
διευκολύνει	διευκολυνω
διευκολύνουμε	διευκολυνω
διευκρίνιση	διευκρινιση
διευκρινίζονται	διευκρινιζω
διευκρινιστεί	διευκρινιζω
διευκόλυνση	διευκολυνση
διευρυμένης	διευρυνω
διευρύνθηκε	διευρυνω
διεύθυνσης	διευθυνση
διεύρυνση	διευρυνση
διεύρυνσης	διευρυνση
δικαιωμάτων	δικαιωμα
δικαιώματα	δικαιωμα
δικαίωμα	δικαιωμα
δικαιωμάτων	δικαιωμα
δικαιώματα	δικαιωμα
δικαιοδοσία	δικαιοδοσια
δικαιολογία	δικαιολογια
δικαιολογημένοι	δικαιολογημενος
δικαιολογεί	δικαιολογω
δικαιολογημένα	δικαιολογω
δικαιοσύνη	δικαιοσυνη
δικαιοσύνης	δικαιοσυνη
δικαιοσύνη	δικαιοσυνη
δικαιοσύνης	δικαιοσυνη
δικαστήριο	δικαστηριο
δικαστηρίου	δικαστηριο
δικαστήρια	δικαστηριο
δικαστήριο	δικαστηριο
δικαστηρίου	δικαστηριο
δικαστές	δικαστης
δικαστής	δικαστης
δικαστικό	δικαστικος
δικαστικής	δικαστικος
δικαστικό	δικαστικος
δικαστικών	δικαστικος
δικαστικών	δικαστικος
δικηγόρους	δικηγορος
δικτατορία	δικτατορια
δικό	δικος
δικά	δικος
δικές	δικος
δική	δικος
δικής	δικος
δικό	δικος
διμερείς	διμερης
διοίκηση	διοικηση
διοίκηση	διοικηση
διοικητηρίου	διοικητηριο
διοικητή	διοικητης
διοικητή	διοικητης
διοικητικά	διοικητικος
διοικητικών	διοικητικος
διονυσίου	διονυσιος
διοξειδίου	διοξειδιο
διορίζονται	διοριζω
διοργάνωσης	διοργανωση
διοργανική	διοργανικη
διοργανικές	διοργανικος
διοργανώθηκε	διοργανωνω
διοργάνωσε	διοργανωνω
διοργανωθεί	διοργανωνω
διοργανώσουμε	διοργανωνω
διορισμοί	διορισμος
διορισμούς	διορισμος
διορισμός	διορισμος
διοχετεύθηκαν	διοχετευω
διπλασιάσει	διπλασιαζω
διπλωματία	διπλωματια
διπλωματίας	διπλωματια
διπλωματικές	διπλωματικος
διπλωματικό	διπλωματικος
δισεκατομμυρίων	δισεκατομμυριο
δισεκατομμύρια	δισεκατομμυριο
δισεκατομμύριο	δισεκατομμυριο
διχασμού	διχασμος
διχασμό	διχασμος
διχλωροβενζόλιο	διχλωροβενζολιο
διονύσου	διονυσος
διώχθηκαν	διωκω
έδιωξε	διωχνω
διώξουν	διωχνω
δοκιμάσουμε	δοκιμαζω
δοκιμές	δοκιμη
δοκιμή	δοκιμη
δολάρια	δολαριο
δολάρια	δολαριο
δολάριο	δολαριο
δολαρίων	δολαριο
δολοφονίας	δολοφονια
δολοφονίες	δολοφονια
δολοφονική	δολοφονικος
δολοφόνησαν	δολοφονω
δομών	δομη
δομημένο	δομω
δοσιλογικών	δοσιλογικος
δουλειά	δουλεια
δουλειές	δουλεια
δούλεψαν	δουλευω
δράμα	δραμα
δράση	δραση
δράσεις	δραση
δράσεων	δραση
δράση	δραση
δράσης	δραση
δράστη	δραστης
δράστης	δραστης
δράστης	δραστης
δραστών	δραστης
δράττομαι	δραττω
δρέπανον	δρεπανο
δραστήρια	δραστηρια
δραστηριοποιούμενους	δραστηριοποιουμενος
δραστηριοποιείται	δραστηριοποιω
δραστηριοποιηθούν	δραστηριοποιω
δραστηριοτήτων	δραστηριοτητα
δραστηριότητες	δραστηριοτητα
δραστικά	δραστικα
δραστικές	δραστικος
δραχμή	δραχμη
δρεπάνι	δρεπανι
δριμύτατη	δριμυς
δριμύτερες	δριμυς
δροζ	δροζ
δρομάκια	δρομακι
δρομολογήσει	δρομολογω
δρομολόγησή	δρομολογηση
δρομολόγηση	δρομολογηση
δρομολόγια	δρομολογιο
δρυμείας	δρυμειας
έδρασε	δρω
δράσουν	δρω
δρόμο	δρομος
δρόμος	δρομος
δρόμους	δρομος
δυναμικά	δυναμικα
δυναμικού	δυναμικος
δυνάμωσαν	δυναμωνω
δυνατές	δυνατος
δυνατή	δυνατος
δυνατής	δυνατος
δυνατό	δυνατος
δυνατόν	δυνατος
δυνατότητα	δυνατοτητα
δυνατότητες	δυνατοτητα
δυνητικά	δυνητικα
δυρράχιο	δυρραχιο
δυσκίνητα	δυσκινητος
δυσκολίες	δυσκολια
δυσπρόσιτα	δυσπροσιτος
δυστυχώς	δυστυχως
δυστυχώς	δυστυχως
δυστυχήματος	δυστυχημα
δυστυχημάτων	δυστυχημα
δυσφημίσει	δυσφημιζω
δυσχερέστερη	δυσχερης
δυτικά	δυτικα
δυτικοαφρικανική	δυτικοαφρικανικος
δυτικά	δυτικος
δυτική	δυτικος
δυτικής	δυτικος
δυτικές	δυτικος
δυτικής	δυτικος
δυτικό	δυτικος
δυτικών	δυτικος
δωμάτιο	δωματιο
δωρεών	δωρεα
δωρικού	δωρικος
δωροδοκία	δωροδοκια
δόγμα	δογμα
δόνησης	δονηση
δυνάμεις	δυναμη
δυνάμεων	δυναμη
δύναμη	δυναμη
δυνάμεις	δυναμη
δυνάμεων	δυναμη
δύναμη	δυναμη
δύναμης	δυναμη
δύναμης	δυναμη
δύση	δυση
δύσης	δυση
δύσεως	δυση
δυσκολότερο	δυσκολος
δύσκολες	δυσκολος
δύσκολη	δυσκολος
δύσκολο	δυσκολος
ειδήσεων	ειδηση
ειδήσεων	ειδηση
είδη	ειδος
είδος	ειδος
είδους	ειδος
ήμασταν	ειμαι
ήσαν	ειμαι
ήταν	ειμαι
είμαστε	ειμαι
είναι	ειμαι
είσοδο	εισοδος
είσοδος	εισοδος
εισόδου	εισοδος
είσπραξης	εισπραξη
εαμ	εαμ
εαμικού	εαμικος
εαρινή	εαρινος
εαυτό	εαυτος
εβδομάδα	εβδομαδα
εβδομάδας	εβδομαδα
εβδομάδες	εβδομαδα
εβδομάδων	εβδομαδα
εβραίους	εβραιος
εβραϊκής	εβραικος
εγγενή	εγγενης
εγγενών	εγγενης
εγγυητριών	εγγυητρια
εγγυάται	εγγυωμαι
εγγυηθούμε	εγγυωμαι
εγγυώνται	εγγυωμαι
εγγυήσεις	εγγυηση
εγγύησης	εγγυηση
εγγύς	εγγυς
εγγύτητα	εγγυτητα
εγκέφαλο	εγκεφαλος
εγκέφαλος	εγκεφαλος
εγκεφάλου	εγκεφαλος
εγκεφάλων	εγκεφαλος
εγκίζ	εγκιζ
εγκαθίδρυση	εγκαθιδρυση
εγκατάλειψης	εγκαταλειψη
εγκατάστασης	εγκατασταση
εγκαταστάσεις	εγκατασταση
εγκαταλείπουν	εγκαταλειπω
εγκαταλείφθηκε	εγκαταλειπω
εγκαταλείψει	εγκαταλειπω
εγκαταλείψουν	εγκαταλειπω
εγκαταλειμμένες	εγκαταλειπω
εγκεφαλικό	εγκεφαλικος
εγκληματική	εγκληματικος
εγκληματικών	εγκληματικος
εγκεκριμένη	εγκρινω
εγκρίθηκαν	εγκρινω
εγκρίθηκε	εγκρινω
εγκρίναμε	εγκρινω
εγκρίνει	εγκρινω
εγκρίνουμε	εγκρινω
εγκρίνουν	εγκρινω
εγκριθεί	εγκρινω
ενέκρινε	εγκρινω
εγκώμιο	εγκωμιο
εγναντία	εγναντια
εγνατίας	εγνατια
εγχείρημα	εγχειρημα
εγωιστικά	εγωιστικα
εδαφικές	εδαφικος
εδες	εδες
εδραιωθεί	εδραιωνω
εδραιωθούν	εδραιωνω
εδώ	εδω
εδώ	εδω
εθελοντές	εθελοντης
εθελοντικά	εθελοντικα
εθελοντική	εθελοντικος
εθελοντικής	εθελοντικος
εθνικισμού	εθνικισμος
εθνικιστής	εθνικιστης
εθνική	εθνικος
εθνικής	εθνικος
εθνικού	εθνικος
εθνικό	εθνικος
εθνικά	εθνικος
εθνικές	εθνικος
εθνική	εθνικος
εθνικής	εθνικος
εθνικού	εθνικος
εθνικούς	εθνικος
εθνικό	εθνικος
εθνικών	εθνικος
εθνοσυνέλευσης	εθνοσυνελευση
εθνοφρουρών	εθνοφρουρος
εθνοφυλακή	εθνοφυλακη
εθνοτήτων	εθνοτητα
εθνότητα	εθνοτητα
εθνότητας	εθνοτητα
ειδάλλως	ειδαλλως
ειδησεογραφικά	ειδησεογραφικος
ειδικά	ειδικα
ειδικότερα	ειδικα
ειδικά	ειδικα
ειδικότερα	ειδικα
ειδικά	ειδικος
ειδική	ειδικος
ειδικής	ειδικος
ειδικούς	ειδικος
ειδικό	ειδικος
ειδικών	ειδικος
ειδοποίηση	ειδοποιηση
ειδοποιούν	ειδοποιω
εικονίστρας	εικονιστρα
εικοσαετίας	εικοσαετια
εικόνες	εικονα
εικόνα	εικονα
εικόνες	εικονα
ειλικρινά	ειλικρινα
ειλικρινείς	ειλικρινης
ειρήνης	ειρηνη
ειρήνη	ειρηνη
ειρήνης	ειρηνη
ειρηνευτική	ειρηνευτικος
ειρηνευτικές	ειρηνευτικος
ειρηνευτική	ειρηνευτικος
ειρηνευτικών	ειρηνευτικος
ειρηνικά	ειρηνικα
ειρηνικές	ειρηνικος
ειρωνικά	ειρωνικος
εισάγεται	εισαγω
εισάγοντας	εισαγω
εισάγουμε	εισαγω
εισήχθη	εισαγω
εισαχθούν	εισαγω
εισέρχονται	εισερχομαι
εισήλθαν	εισερχομαι
εισήλθε	εισερχομαι
εισήγηση	εισηγηση
εισαγγελέα	εισαγγελεας
εισαγγελέας	εισαγγελεας
εισαγγελείς	εισαγγελεας
εισαγγελική	εισαγγελικος
εισαγωγές	εισαγωγη
εισαγωγή	εισαγωγη
εισαγωγής	εισαγωγη
εισέβαλε	εισβαλλω
εισβάλλει	εισβαλλω
εισβολείς	εισβολεας
εισβολή	εισβολη
εισβολή	εισβολη
εισβολής	εισβολη
εισηγήτρια	εισηγητρια
εισηγητές	εισηγητης
εισηγητή	εισηγητης
εισηγητής	εισηγητης
εισπράτταμε	εισπραττω
εισροή	εισροη
εισφορές	εισφορα
εισοδήματα	εισοδημα
εισοδημάτων	εισοδημα
εισόδημα	εισοδημα
εκ	εκ
εκάστοτε	εκαστοτε
εκατομμυρίων	εκατομμυριο
εκατομμύρια	εκατομμυριο
εκατομμύριο	εκατομμυριο
εκατοστιαίας	εκατοστιαιος
εκατόμβη	εκατομβη
εκβάλλει	εκβαλλω
εκβάλλει	εκβαλλω
εκβατήριας	εκβατηριος
εκβολών	εκβολη
εκδήλωση	εκδηλωση
εκδοθεί	εκδιδω
εκδόθηκαν	εκδιδω
εκδόθηκε	εκδιδω
εκδώσει	εκδιδω
εξέδωσαν	εκδιδω
εξέδωσε	εκδιδω
εκδίωξη	εκδιωξη
εκδίωξης	εκδιωξη
εκδηλώθηκε	εκδηλωνω
εκδιωχθούν	εκδιωκω
εκδοθεισών	εκδοθεις
εκδοχές	εκδοχη
εκδοχή	εκδοχη
εκεί	εκει
εκεί	εκει
εκείνο	εκεινος
εκθέσω	εκθετω
εκτέθηκαν	εκθετω
εκτίθενται	εκθετω
εκτίθεται	εκθετω
εξέθεσε	εκθετω
εκκένωση	εκκενωση
εκκίνησης	εκκινηση
εκκενώσουν	εκκενωνω
εκκλησάκια	εκκλησακι
εκκλησία	εκκλησια
εκκλησίας	εκκλησια
εκκλησία	εκκλησια
εκκλησίες	εκκλησια
εκκλησιές	εκκλησια
εκκλησιαστικά	εκκλησιαστικος
εκκρεμούσε	εκκρεμω
εκλέχθηκε	εκλεγω
εκλεγμένο	εκλεγω
εκλεγμένος	εκλεγω
εξελέγη	εκλεγω
εκλέκτορες	εκλεκτορας
εκλείπει	εκλειπω
εκλεγέντα	εκλεγεις
εκλεγμένη	εκλεγμενος
εκλεκτορικές	εκλεκτορικος
εκλογών	εκλογη
εκλογές	εκλογη
εκλογή	εκλογη
εκλογών	εκλογη
εκλογικού	εκλογικος
εκλογική	εκλογικος
εκλογικού	εκλογικος
εξέπεμψε	εκπεμπω
εκπαίδευσή	εκπαιδευση
εκπαίδευση	εκπαιδευση
εκπαίδευσης	εκπαιδευση
εκπαιδευτικό	εκπαιδευτικος
εκπαιδευτικών	εκπαιδευτικος
εκπαιδεύονται	εκπαιδευω
εκπαιδεύεται	εκπαιδευω
εκπατρίστηκαν	εκπατριζομαι
εκπλήρωση	εκπληρωση
εκπλήσσει	εκπλησσω
εκπληκτικής	εκπληκτικος
εκπληρωθεί	εκπληρωνω
εκπληρωθούν	εκπληρωνω
εκπληρώνει	εκπληρωνω
εκπληρώσει	εκπληρωνω
εκπομπές	εκπομπη
εκπομπή	εκπομπη
εκπομπής	εκπομπη
εκπομπών	εκπομπη
εκπόνησε	εκπονω
εκπροσωπήσουμε	εκπροσωπω
εκπροσωπεί	εκπροσωπω
εκπροσωπείται	εκπροσωπω
εκπροσωπούνται	εκπροσωπω
εκπροσώπησης	εκπροσωπηση
εκπροσώπηση	εκπροσωπηση
εκπροσώπησης	εκπροσωπηση
εκπρόσωπε	εκπροσωπος
εκπρόσωπο	εκπροσωπος
εκπρόσωποι	εκπροσωπος
εκπρόσωπος	εκπροσωπος
εκπροσώπους	εκπροσωπος
εκπρόσωπο	εκπροσωπος
εκπρόσωποι	εκπροσωπος
εκπρόσωπος	εκπροσωπος
εξερράγη	εκρηγνυμαι
εκρηκτικά	εκρηκτικα
εκρηκτικά	εκρηκτικος
εκσκαφείς	εκσκαφεας
εκστρατεία	εκστρατεια
εκστρατείας	εκστρατεια
εκσυγχρονισμός	εκσυγχρονισμος
εκτέλεση	εκτελεση
εκτέλεσης	εκτελεση
εκτίμηση	εκτιμηση
εκτιμήσεις	εκτιμηση
εκτείνεται	εκτεινω
εκτεινόταν	εκτεινω
εκτελεστική	εκτελεστικος
εκτελεστός	εκτελεστος
εκτελέστηκε	εκτελω
εκτελούν	εκτελω
εκτελούνται	εκτελω
εκτελούσε	εκτελω
εκτεταμένα	εκτεταμενος
εκτεταμένων	εκτεταμενος
εκτιμά	εκτιμω
εκτιμήσει	εκτιμω
εκτιμημένη	εκτιμω
εκτοπίσουν	εκτοπιζω
εκτόπισε	εκτοπιζω
εκτόνωση	εκτονωση
εκτοξεύσεων	εκτοξευση
εκτός	εκτος
εκτός	εκτος
εκφράζουμε	εκφραζω
εκφράζει	εκφραζω
εκφράζοντας	εκφραζω
εκφράζω	εκφραζω
εκφράσαμε	εκφραζω
εκφράσει	εκφραζω
εκφράστηκε	εκφραζω
εκφράσω	εκφραζω
εκφραστεί	εκφραζω
εξέφρασαν	εκφραζω
εξέφρασε	εκφραζω
εκχωρήσει	εκχωρω
ελάχιστες	ελαχιστος
ελάχιστο	ελαχιστος
ελάχιστοι	ελαχιστος
ελέγξει	ελεγχω
ελέγχει	ελεγχω
ελέγχεται	ελεγχω
ελέγχονται	ελεγχω
ελέγχονταν	ελεγχω
ελένη	ελενη
ελασίτη	ελασιτης
ελαφρά	ελαφρα
ελαχιστοποίηση	ελαχιστοποιηση
ελεγκτές	ελεγκτης
ελεγκτών	ελεγκτης
ελεγκτικού	ελεγκτικος
ελεγχόμενη	ελεγχομενος
ελευθέρωση	ελευθερωση
ελευθέρωσης	ελευθερωση
ελευθερία	ελευθερια
ελευθερίας	ελευθερια
ελευθερίες	ελευθερια
ελευθεριών	ελευθερια
ελεύθερα	ελευθερα
ελεύθερης	ελευθερος
ελεύθερος	ελευθερος
ελεύθερη	ελευθερος
ελεύθερης	ελευθερος
ελεύθερο	ελευθερος
ελεύθεροι	ελευθερος
ελεύθερος	ελευθερος
ελεύθερό	ελευθερος
ελιές	ελια
ελιγμού	ελιγμος
ελκύει	ελκυω
ελλάδα	ελλαδα
ελλάδας	ελλαδα
ελλάδος	ελλαδα
ελλάδος	ελλας
ελλάς	ελλας
ελληνική	ελληνικος
ελληνικής	ελληνικος
ελληνικού	ελληνικος
ελληνικός	ελληνικος
ελληνικά	ελληνικος
ελληνικές	ελληνικος
ελληνική	ελληνικος
ελληνικής	ελληνικος
ελληνικού	ελληνικος
ελληνικό	ελληνικος
ελληνικών	ελληνικος
ελληνιστική	ελληνιστικος
ελληνοκυπριακές	ελληνοκυπριακος
ελληνοκυπριακή	ελληνοκυπριακος
ελληνοκυπρίων	ελληνοκυπριος
ελληνοτουρκικό	ελληνοτουρκικος
ελληνόφωνα	ελληνοφωνος
ελπίδες	ελπιδα
ελπίζουμε	ελπιζω
ελπίζω	ελπιζω
ελπίζει	ελπιζω
ελπίζοντας	ελπιζω
ελπίζουμε	ελπιζω
ελπίζω	ελπιζω
ελσίνκι	ελσινκι
εμβέλεια	εμβελεια
εμβολιαστούν	εμβολιαζω
εμβολιασμού	εμβολιασμος
εμβολιαστικής	εμβολιαστικος
εμβολίου	εμβολιο
εμβολίων	εμβολιο
εμβόλια	εμβολιο
εμβόλιο	εμβολιο
εμμένει	εμμενω
εμμονής	εμμονη
εμπάργκο	εμπαργκο
εμπάργκο	εμπαργκο
εμπαιγμός	εμπαιγμος
εμπειρία	εμπειρια
εμπειρίες	εμπειρια
εμπειριών	εμπειρια
εμπειρογνωμοσύνη	εμπειρογνωμοσυνη
εμπειρογνώμονες	εμπειρογνωμονας
εμπιστοσύνη	εμπιστοσυνη
εμπιστοσύνης	εμπιστοσυνη
εμπλέκεται	εμπλεκω
εμπλέκονται	εμπλεκω
εμπλέκονταν	εμπλεκω
εμπλεκομένων	εμπλεκομενος
εμπλεκόμενοι	εμπλεκομενος
εμπλοκή	εμπλοκη
εμποδίσει	εμποδιζω
εμπορία	εμπορια
εμπορευματικών	εμπορευματικος
εμπορικά	εμπορικος
εμπορική	εμπορικος
εμπορικό	εμπορικος
εμπρός	εμπρος
εμπόδια	εμποδιο
εμπόδιο	εμποδιο
εμπόλεμη	εμπολεμος
εμπόλεμης	εμπολεμος
εμπορίου	εμποριο
εμπορίου	εμποριο
εμπόριο	εμποριο
εμφανίσεις	εμφανιση
εμφανές	εμφανης
εμφανή	εμφανης
εμφανής	εμφανης
εμφανίζονται	εμφανιζω
εμφανίζουν	εμφανιζω
εμφανίστηκε	εμφανιζω
εμφανιστεί	εμφανιζω
εμφυλίου	εμφυλιος
εμφυλίου	εμφυλιος
ενάντια	εναντια
ενέργειας	ενεργεια
ενέργειές	ενεργεια
ενέργεια	ενεργεια
ενέργειας	ενεργεια
ενέργειες	ενεργεια
ενεργειών	ενεργεια
ενήμερες	ενημερος
ενίστανται	ενισταμαι
ενίσχυσης	ενισχυση
ενισχύσεις	ενισχυση
εναέριο	εναεριος
εναλλακτικά	εναλλακτικα
εναλλακτικές	εναλλακτικος
εναλλακτική	εναλλακτικος
εναλλακτικού	εναλλακτικος
εναλλασσόμενη	εναλλασσομενος
εναντιώθηκε	εναντιωνομαι
εναποθέτοντας	εναποθετω
εναπομείναντες	εναπομεινας
εναρμόνιση	εναρμονιση
εναρμόνισης	εναρμονιση
ενδέχεται	ενδεχεται
ενδεδειγμένο	ενδεικνυμαι
ενδεικτική	ενδεικτικος
ενδεχομένως	ενδεχομενως
ενδεχόμενο	ενδεχομενο
ενδεχόμενα	ενδεχομενος
ενδεχόμενη	ενδεχομενος
ενδεχόμενης	ενδεχομενος
ενδιάμεση	ενδιαμεσος
ενδιάμεσο	ενδιαμεσος
ενδιαφέρον	ενδιαφερον
ενδιαφέροντος	ενδιαφερον
ενδιαφέρει	ενδιαφερω
ενδιαφέρεστε	ενδιαφερω
ενδιαφέρονται	ενδιαφερω
ενδιαφέρουν	ενδιαφερω
ενδιαφερόμαστε	ενδιαφερω
ενδιαφέρουσα	ενδιαφερων
ενδιαφέρουσες	ενδιαφερων
ενδυναμώνει	ενδυναμωνω
ενεργά	ενεργα
ενεργειακό	ενεργειακος
ενεργού	ενεργος
ενεργό	ενεργος
ενεργήσει	ενεργω
ενεργούμε	ενεργω
ενεργούν	ενεργω
ενετοί	ενετος
ενετών	ενετος
ενημέρωση	ενημερωση
ενημέρωσης	ενημερωση
ενημέρωσε	ενημερωνω
ενημερώνουν	ενημερωνω
ενημερώσει	ενημερωνω
ενθαρρυντικά	ενθαρρυντικος
ενθαρρυντικά	ενθαρρυντικος
ενθαρρυντικό	ενθαρρυντικος
ενεθάρρυνα	ενθαρρυνω
ενθαρρύνει	ενθαρρυνω
ενθαρρύνοντας	ενθαρρυνω
ενθαρρύνουμε	ενθαρρυνω
ενθαρρύνω	ενθαρρυνω
ενθουσιασμό	ενθουσιασμος
ενθρονίστηκε	ενθρονιζω
ενιαία	ενιαιος
ενιαίας	ενιαιος
ενιαίες	ενιαιος
ενιαίο	ενιαιος
ενιαίου	ενιαιος
ενισχύει	ενισχυω
ενισχύθηκαν	ενισχυω
ενισχύσει	ενισχυω
ενισχύσουμε	ενισχυω
ενισχύσουν	ενισχυω
ενλόγω	ενλογω
εννιά	εννεα
εννεάμηνο	εννεαμηνος
εννοηθεί	εννοω
ενοικιάσουν	ενοικιαζω
ενοποίηση	ενοποιηση
ενοποιημένες	ενοποιω
ενστάλαξαν	ενσταλαζω
ενσωμάτωση	ενσωματωση
ενσωμάτωσης	ενσωματωση
ενσωματωθούν	ενσωματωνω
ενσωματώθηκαν	ενσωματωνω
ενσωματώθηκε	ενσωματωνω
ενσωματώνει	ενσωματωνω
ενσωματώνεται	ενσωματωνω
ενσωματώσουμε	ενσωματωνω
εντάξει	ενταξει
εντάξατε	εντασσω
εντάξει	εντασσω
εντάξουμε	εντασσω
εντάσσεται	εντασσω
εντάσσονται	εντασσω
εντάσσω	εντασσω
εντάχθηκε	εντασσω
εντατικοποίηση	εντατικοποιηση
εντατικοποιηθεί	εντατικοποιω
εντατικοποιούμε	εντατικοποιω
εντατικές	εντατικος
εντατική	εντατικος
εντείνονται	εντεινω
εντελώς	εντελως
εντολή	εντολη
εντολής	εντολη
εντοπίζονται	εντοπιζω
εντοπίστηκε	εντοπιζω
εντόπισαν	εντοπιζω
εντοπισμό	εντοπισμος
εντούτοις	εντουτοις
εντούτοις	εντουτοις
εντυπωσιακά	εντυπωσιακος
εντυπωσιακή	εντυπωσιακος
εντός	εντος
εντύπωση	εντυπωση
εντύπωσης	εντυπωση
ενότητας	ενοτητα
ενότητα	ενοτητα
ενότητας	ενοτητα
ένωνε	ενωνω
ενωμένη	ενωνω
ενώνει	ενωνω
ενώνονται	ενωνω
εξάγονται	εξαγω
εξάλειψη	εξαλειψη
εξάλειψης	εξαλειψη
εξάλλου	εξαλλου
εξάλλου	εξαλλου
εξάμηνη	εξαμηνος
εξάπλωση	εξαπλωση
εξάρθρωση	εξαρθρωση
εξάρτηση	εξαρτηση
εξέγερση	εξεγερση
εξέλιξη	εξελιξη
εξελίξεις	εξελιξη
εξέταση	εξεταση
εξέχοντα	εξεχων
εξής	εξης
εξίσου	εξισου
εξίσου	εξισου
εξαίρεση	εξαιρεση
εξαίρεσης	εξαιρεση
εξαίρετη	εξαιρετος
εξαίρετο	εξαιρετος
εξαγγελθεί	εξαγγελλω
εξαγοράς	εξαγορα
εξαγωγικές	εξαγωγικος
εξαιρετικά	εξαιρετικα
εξαιρετική	εξαιρετικος
εξαιρετικής	εξαιρετικος
εξαιρετικό	εξαιρετικος
εξαιρούνταν	εξαιρω
εξαιρώντας	εξαιρω
εξακολουθήσουμε	εξακολουθω
εξακολουθεί	εξακολουθω
εξακολουθούμε	εξακολουθω
εξακολουθούν	εξακολουθω
εξακρίβωσε	εξακριβωνω
εξακριβώσει	εξακριβωνω
εξαμηνιαίας	εξαμηνιαιος
εξαναγκάσουν	εξαναγκαζω
εξανεμίζονται	εξανεμιζω
εξαντλητική	εξαντλητικος
εξαντληθούν	εξαντλω
εξαπολύσει	εξαπολυω
εξαρθρώθηκε	εξαρθρωνω
εξαρτάται	εξαρτω
εξαρτημένα	εξαρτω
εξαρχίας	εξαρχια
εξασφάλιση	εξασφαλιση
εξασφαλίζει	εξασφαλιζω
εξασφαλίζουν	εξασφαλιζω
εξασφαλίσει	εξασφαλιζω
εξασφαλίσουμε	εξασφαλιζω
εξασφαλιστεί	εξασφαλιζω
εξεγερμένους	εξεγερμενος
εξειδίκευση	εξειδικευση
εξελίσσεται	εξελισσω
εξελισσόταν	εξελισσω
εξετάζει	εξεταζω
εξετάζονται	εξεταζω
εξετάζουμε	εξεταζω
εξετάσαμε	εξεταζω
εξετάσει	εξεταζω
εξετάσθηκαν	εξεταζω
εξετάσθηκε	εξεταζω
εξετάσουμε	εξεταζω
εξετάσουν	εξεταζω
εξετάσω	εξεταζω
εξεταστούν	εξεταζω
εξευρεθεί	εξευρισκω
εξήγησε	εξηγω
εξηγήσαμε	εξηγω
εξηγήσω	εξηγω
εξηγεί	εξηγω
εξοικονόμηση	εξοικονομηση
εξολοκλήρου	εξολοκληρου
εξοπλισμού	εξοπλισμος
εξουδετερώσει	εξουδετερωνω
εξουσία	εξουσια
εξουσίας	εξουσια
εξουσίες	εξουσια
εξουσίαζαν	εξουσιαζω
εξουσιοδοτηθεί	εξουσιοδοτω
εξουσιοδότησε	εξουσιοδοτω
εξτρεμιστές	εξτρεμιστης
εξτρεμιστών	εξτρεμιστης
εξυπηρετήσουν	εξυπηρετω
εξυπηρετούσε	εξυπηρετω
εξωευρωπαϊκή	εξωευρωπαικη
εξωθούσαν	εξωθω
εξωτερικών	εξωτερικα
εξωτερικό	εξωτερικο
εξωτερικές	εξωτερικος
εξωτερική	εξωτερικος
εξωτερικό	εξωτερικος
εξόριστη	εξοριστος
εξόριστο	εξοριστος
εξόριστοι	εξοριστος
εξόριστος	εξοριστος
εξόριστους	εξοριστος
εξόριστων	εξοριστος
εξόρυξή	εξορυξη
εξόρυξης	εξορυξη
επέκταση	επεκταση
επέμβαση	επεμβαση
επέμβασης	επεμβαση
επεμβάσεις	επεμβαση
επένδυση	επενδυση
επενδύσεις	επενδυση
επενδύσεων	επενδυση
επίγνωση	επιγνωση
επιδόσεις	επιδοση
επιδράσεις	επιδραση
επίθεση	επιθεση
επίθεση	επιθεση
επίθεσης	επιθεση
επιθέσεις	επιθεση
επιθέσεων	επιθεση
επίθετο	επιθετο
επίκαιρο	επικαιρος
επίκεντρο	επικεντρο
επίκριση	επικριση
επικρίσεις	επικριση
επίλυση	επιλυση
επίμαχη	επιμαχος
επίπεδα	επιπεδο
επίπεδο	επιπεδο
επιπέδου	επιπεδο
επίπονο	επιπονος
επιπτώσεις	επιπτωση
επιπτώσεων	επιπτωση
επιρρίψεις	επιρριψη
επίσημα	επισημα
επισήμως	επισημα
επίσημη	επισημος
επίσημα	επισημος
επίσημες	επισημος
επίσημη	επισημος
επίσημο	επισημος
επίσης	επισης
επίσης	επισης
επίσκεψής	επισκεψη
επίσκεψη	επισκεψη
επίσκεψης	επισκεψη
επισκόπους	επισκοπος
επίσπευση	επισπευση
επίτευγμα	επιτευγμα
επιτεύγματα	επιτευγμα
επίτευξή	επιτευξη
επίτευξη	επιτευξη
επίτευξης	επιτευξη
επίτροπε	επιτροπος
επίτροπο	επιτροπος
επίτροπος	επιτροπος
επιτρόπου	επιτροπος
επαγγελματιών	επαγγελματιας
επαγγελματική	επαγγελματικος
επαγγελματικής	επαγγελματικος
επακολούθησε	επακολουθω
επακριβείς	επακριβης
επανάληψη	επαναληψη
επανάσταση	επανασταση
επανάστασης	επανασταση
επαναστάσεις	επανασταση
επανέναρξη	επανεναρξη
επανένταξης	επανενταξη
επανένωση	επανενωση
επανέρχομαι	επανερχομαι
επανήλθε	επανερχομαι
επανέλαβε	επαναλαμβανω
επαναλάβει	επαναλαμβανω
επαναλάβω	επαναλαμβανω
επαναληπτικού	επαναληπτικος
επαναπατρισμένη	επαναπατριζω
επαναπατρισμός	επαναπατρισμος
επαναπρόσληψή	επαναπροσληψη
επαναστάτες	επαναστατης
επαναστατική	επαναστατικος
επαναστατικής	επαναστατικος
επαναστατικού	επαναστατικος
επαναστατικό	επαναστατικος
επανασύνδεση	επανασυνδεση
επανέφερε	επαναφερω
επαναφέρει	επαναφερω
επαναφορά	επαναφορα
επαναφοράς	επαναφορα
επανειλημμένα	επανειλημμενα
επανεκλογή	επανεκλογη
επανεξετάσει	επανεξεταζω
επανεξετάσουμε	επανεξεταζω
επανεξετασθούν	επανεξεταζω
επανορθώσεων	επανορθωση
επαρκή	επαρκης
επαρκώς	επαρκως
επαρχία	επαρχια
επαρχίας	επαρχια
επαρχίες	επαρχια
επαφές	επαφη
επαφή	επαφη
επαφής	επαφη
επαφίενται	επαφιεμαι
επαχθείς	επαχθης
επείγον	επειγων
επείγοντα	επειγων
επείγουσα	επειγων
επειγόντως	επειγοντως
επεισόδιο	επεισοδιο
επεκτατική	επεκτατικος
επεκταθεί	επεκτεινω
επεκταθώ	επεκτεινω
επεκτείνοντας	επεκτεινω
επέμβει	επεμβαινω
επέμβουν	επεμβαινω
επενέβη	επεμβαινω
επεξεργασθήκαμε	επεξεργαζομαι
επεξεργασθούμε	επεξεργαζομαι
επεξεργαστούν	επεξεργαζομαι
επεξεργασίας	επεξεργασια
επερχόμενη	επερχομενος
επηρεάζει	επηρεαζω
επηρεάζουν	επηρεαζω
επηρεάσει	επηρεαζω
επηρεάσουν	επηρεαζω
επηρεασμένοι	επηρεαζω
επηρεαστούν	επηρεαζω
επιβάλετε	επιβαλλω
επιβάλλει	επιβαλλω
επιβάλλεται	επιβαλλω
επιβάλλονται	επιβαλλω
επιβάλουν	επιβαλλω
επιβλήθηκαν	επιβαλλω
επιβλήθηκε	επιβαλλω
επιβληθεί	επιβαλλω
επιβληθούν	επιβαλλω
επιβάρυνση	επιβαρυνση
επιβαρύνσεις	επιβαρυνση
επιβαρύνσεων	επιβαρυνση
επιβάτες	επιβατης
επιβίωση	επιβιωση
επιβαρυντικό	επιβαρυντικος
επιβαρύνουμε	επιβαρυνω
επιβαρύνουν	επιβαρυνω
επιβατικών	επιβατικος
επιβεβαίωσαν	επιβεβαιωνω
επιβεβαίωσε	επιβεβαιωνω
επιβεβαιώθηκε	επιβεβαιωνω
επιβεβαιώνει	επιβεβαιωνω
επιβεβαιώσει	επιβεβαιωνω
επιβλαβείς	επιβλαβης
επιβλητικό	επιβλητικος
επιβολή	επιβολη
επιβολής	επιβολη
επιδέχεται	επιδεχομαι
επιδέχονται	επιδεχομαι
επιδοθεί	επιδιδω
επιδόθηκε	επιδιδω
επιδίωξη	επιδιωξη
επιδείνωση	επιδεινωση
επέδειξαν	επιδεικνυω
επέδειξε	επιδεικνυω
επιδεικνύεται	επιδεικνυω
επιδεινώνεται	επιδεινωνω
επιδεινώσουν	επιδεινωνω
επιδημία	επιδημια
επιδημίας	επιδημια
επιδιώκουν	επιδιωκουν
επεδίωξαν	επιδιωκω
επιδιωχθεί	επιδιωκω
επιδιώκει	επιδιωκω
επιδιώκοντας	επιδιωκω
επιδιώκουμε	επιδιωκω
επιδιώκουν	επιδιωκω
επιδιώξει	επιδιωκω
επιδοκιμάζω	επιδοκιμαζω
επιδρομές	επιδρομη
επιδοτήσεις	επιδοτηση
επιζώντες	επιζων
επιθετική	επιθετικος
επιθεωρήσεων	επιθεωρηση
επιθυμία	επιθυμια
επιθυμία	επιθυμια
επιθυμητής	επιθυμητος
επιθυμώ	επιθυμω
επιθυμεί	επιθυμω
επιθυμούμε	επιθυμω
επιθυμούν	επιθυμω
επιθυμούσαμε	επιθυμω
επιθυμούσαν	επιθυμω
επιθυμώ	επιθυμω
επικίνδυνα	επικινδυνα
επικίνδυνα	επικινδυνος
επικαιρότητας	επικαιροτητα
επικαλούμενες	επικαλουμενος
επικείμενη	επικειμενος
επικέντρωσα	επικεντρωνω
επικεντρωθείτε	επικεντρωνω
επικεντρωθούμε	επικεντρωνω
επικεντρώθηκα	επικεντρωνω
επικεντρώνεται	επικεντρωνω
επικεντρώνονται	επικεντρωνω
επικερδής	επικερδης
επικερδώς	επικερδως
επικεφαλής	επικεφαλης
επικεφαλής	επικεφαλης
επικεφαλής	επικεφαλης
επικοινωνία	επικοινωνια
επικοινωνίας	επικοινωνια
επικοινωνίες	επικοινωνια
επικοινωνιακή	επικοινωνιακος
επικοινωνήσει	επικοινωνω
επικοινωνεί	επικοινωνω
επικοινώνησε	επικοινωνω
επικουρικότητα	επικουρικοτητα
επικουρικότητας	επικουρικοτητα
επικράτειάς	επικρατεια
επικράτεια	επικρατεια
επίκρινε	επικρινω
επικρίνει	επικρινω
επικράτησε	επικρατω
επικρατήσει	επικρατω
επικρατεί	επικρατω
επικρατούν	επικρατω
επικρατούσε	επικρατω
επικροτούμε	επικροτω
επικροτώ	επικροτω
επικροτεί	επικροτω
επικροτείτε	επικροτω
επικροτούμε	επικροτω
επικυρώθηκε	επικυρωνω
επέλεξε	επιλεγω
επελέγη	επιλεγω
επιλέγουν	επιλεγω
επιλεκτικά	επιλεκτικα
επιλεκτικών	επιλεκτικος
επιλογές	επιλογη
επιλογή	επιλογη
επιλογής	επιλογη
επιλυθεί	επιλυω
επιλύσει	επιλυω
επιλύσουμε	επιλυω
επιμένω	επιμενω
επέμεινε	επιμενω
επέμεναν	επιμενω
επιμένει	επιμενω
επιμένω	επιμενω
επιμείνει	επιμενω
επιμέρους	επιμερους
επιμονή	επιμονη
επιμόρφωση	επιμορφωση
επιμόρφωσης	επιμορφωση
επιπλέον	επιπλεον
επιπλέον	επιπλεον
επιπρόσθετα	επιπροσθετα
επιρρίπτει	επιρριπτω
επιρροές	επιρροη
επιρροή	επιρροη
επιρροής	επιρροη
επισήμανσή	επισημανση
επισημαίνω	επισημαινω
επεσήμανε	επισημαινω
επισήμανε	επισημαινω
επισημάναμε	επισημαινω
επισημάνατε	επισημαινω
επισημάνω	επισημαινω
επισημαίνει	επισημαινω
επισημαίνοντας	επισημαινω
επισημαίνω	επισημαινω
επισημανθεί	επισημαινω
επισημοποιήθηκε	επισημοποιω
επισκέπτηκαν	επισκεπτηκαν
επισκέπτες	επισκεπτης
επισκέπτη	επισκεπτης
επισκέπτης	επισκεπτης
επισκέπτης	επισκεπτης
επισκέπτεται	επισκεπτομαι
επισκέπτονται	επισκεπτομαι
επισκέφθηκα	επισκεπτομαι
επισκέφθηκε	επισκεπτομαι
επισκέφτηκαν	επισκεπτομαι
επισκεπτόταν	επισκεπτομαι
επισκεφθήκαμε	επισκεπτομαι
επισκεφθεί	επισκεπτομαι
επισκεφθείτε	επισκεπτομαι
επισκεφθούν	επισκεπτομαι
επισκέψιμο	επισκεψιμο
επισκευασθεί	επισκευαζω
επισκευή	επισκευη
επισκευαστές	επισκευαστης
επισκευαστή	επισκευαστης
επισκόπηση	επισκοπηση
επισπευσθεί	επισπευδω
επιστήμονες	επιστημονας
επιστημονικό	επιστημονικος
επιστολές	επιστολη
επιστολής	επιστολη
επιστράτευση	επιστρατευση
επέστρεψε	επιστρεφω
επέστρεψαν	επιστρεφω
επέστρεψε	επιστρεφω
επιστρέφοντας	επιστρεφω
επιστρέψει	επιστρεφω
επιστρέψουν	επιστρεφω
επιστροφή	επιστροφη
επιτάφιος	επιταφιος
επιτάχυνση	επιταχυνση
επιτέλους	επιτελους
επιτήρησης	επιτηρηση
επιτέθηκαν	επιτιθεμαι
επιτέθηκε	επιτιθεμαι
επιτεθούν	επιτιθεμαι
επιτακτική	επιτακτικος
επιτάχυναν	επιταχυνω
επιτάχυνε	επιταχυνω
επιταχύνει	επιταχυνω
επιτέλεσαν	επιτελω
επιτελέσαμε	επιτελω
επιτρέψτε	επιτρεπω
επέτρεπαν	επιτρεπω
επέτρεπε	επιτρεπω
επέτρεψαν	επιτρεπω
επέτρεψε	επιτρεπω
επιτρέπει	επιτρεπω
επιτρέπεται	επιτρεπω
επιτρέπονται	επιτρεπω
επιτρέποντας	επιτρεπω
επιτρέπουν	επιτρεπω
επιτρέψει	επιτρεπω
επιτρέψουμε	επιτρεπω
επιτρέψουν	επιτρεπω
επιτρέψτε	επιτρεπω
επιτραπεί	επιτρεπω
επιτροπή	επιτροπη
επιτροπής	επιτροπη
επιτροπές	επιτροπη
επιτροπή	επιτροπη
επιτροπής	επιτροπη
επιτροπών	επιτροπη
επιτροπών	επιτροπη
επέτυχε	επιτυγχανω
επετεύχθη	επιτυγχανω
επιτευχθεί	επιτυγχανω
επιτευχθούν	επιτυγχανω
επιτεύχθηκαν	επιτυγχανω
επιτεύχθηκε	επιτυγχανω
επιτυγχάνεται	επιτυγχανω
επιτύχει	επιτυγχανω
επιτύχουμε	επιτυγχανω
επιτύχουν	επιτυγχανω
επιτυχές	επιτυχης
επιτυχή	επιτυχης
επιτυχής	επιτυχης
επιτυχείς	επιτυχης
επιτυχούς	επιτυχης
επιτυχία	επιτυχια
επιτυχία	επιτυχια
επιτυχίες	επιτυχια
επιτυχημένες	επιτυχημενος
επιφάνεια	επιφανεια
επέφερε	επιφερω
επιφέρει	επιφερω
επιφυλάξεις	επιφυλαξη
επιχειρήματα	επιχειρημα
επιχείρησή	επιχειρηση
επιχείρηση	επιχειρηση
επιχειρήσεις	επιχειρηση
επιχειρήσεων	επιχειρηση
επιχειρηματικές	επιχειρηματικος
επιχειρηματικού	επιχειρηματικος
επιχειρώντας	επιχειρω
επιχείρησαν	επιχειρω
επιχείρησε	επιχειρω
επιχειρήσει	επιχειρω
επιχειρούν	επιχειρω
επιχειρούσαμε	επιχειρω
επιχειρούσαν	επιχειρω
επιχρυσωμένο	επιχρυσωνω
εποικοδομητικά	εποικοδομητικα
εποικοδομητικές	εποικοδομητικος
εποικοδομητικό	εποικοδομητικος
εποικονωνίας	εποικονωνιας
επομένως	επομενως
επομένως	επομενως
επονομαζόμενης	επονομαζομενος
εποπτεύεται	εποπτευω
εποχή	εποχη
εποχής	εποχη
εποχική	εποχιακος
επτανήσιων	επτανησιος
επωμισθεί	επωμιζομαι
επωμισθούμε	επωμιζομαι
επωφελέστερη	επωφελης
επωφελούνται	επωφελουμαι
επόμενα	επομενος
επόμενες	επομενος
επόμενη	επομενος
επόμενο	επομενος
επόμενου	επομενος
επόμενους	επομενος
επώνυμο	επωνυμο
εργαστήκαμε	εργαζομαι
εργάζεται	εργαζομαι
εργάζονται	εργαζομαι
εργάζονταν	εργαζομαι
εργάσθηκε	εργαζομαι
εργάστηκε	εργαζομαι
εργαζόμαστε	εργαζομαι
εργαζόταν	εργαζομαι
εργασθούν	εργαζομαι
εργαστεί	εργαζομαι
εργαστούμε	εργαζομαι
εργαστούν	εργαζομαι
εργάσιμου	εργασιμος
εργάτες	εργατης
εργάτης	εργατης
εργατών	εργατης
εργαζόμενοι	εργαζομενος
εργαζομένους	εργαζομενος
εργαζομένων	εργαζομενος
εργαζόμενο	εργαζομενος
εργαζόμενοι	εργαζομενος
εργαζόμενους	εργαζομενος
εργαζόμενων	εργαζομενος
εργαλεία	εργαλειο
εργαλείο	εργαλειο
εργασίας	εργασια
εργασία	εργασια
εργασίας	εργασια
εργασίες	εργασια
εργασιών	εργασια
εργαστήρι	εργαστηρι
εργατική	εργατικος
εργατικού	εργατικος
εργοδοτών	εργοδοτης
εργοδότες	εργοδοτης
εργολάβοι	εργολαβος
εργοστασίου	εργοστασιο
εργοστασιακό	εργοστασιακος
ερείπια	ερειπιο
ερευνητική	ερευνητικος
ερευνητικής	ερευνητικος
ερευνά	ερευνω
ερευνήσει	ερευνω
ερμηνεία	ερμηνεια
ερμηνείας	ερμηνεια
ερμηνείες	ερμηνεια
ερμηνευτικές	ερμηνευτικος
ερμηνευτεί	ερμηνευω
ερνέστο	ερνεστο
ερυθράς	ερυθρος
ερυθρού	ερυθρος
ερυθρός	ερυθρος
ερχόμενοι	ερχομενος
ερωτηθέντων	ερωτηθεις
ερωτικά	ερωτικος
ερώτημα	ερωτημα
ερώτηση	ερωτηση
ερώτησης	ερωτηση
εστία	εστια
εστιάζονται	εστιαζω
εστιάσαμε	εστιαζω
εστιάστηκα	εστιαζω
εστιακό	εστιακος
εστιατόρια	εστιατοριο
εστιατόριο	εστιατοριο
εσωκομματικές	εσωκομματικος
εσωτερικών	εσωτερικα
εσωτερικό	εσωτερικο
εσωτερικό	εσωτερικο
εσωτερικής	εσωτερικος
εσωτερική	εσωτερικος
εσωτερικής	εσωτερικος
εσωτερικό	εσωτερικος
εσωτερικών	εσωτερικος
ετήσια	ετησιος
ετήσιο	ετησιος
εταίροι	εταιρος
εταίρους	εταιρος
εταίρων	εταιρος
εταιρεία	εταιρεια
εταιρείας	εταιρεια
εταιρείες	εταιρεια
εταιρειών	εταιρεια
εταιρική	εταιρικος
εταιρικής	εταιρικος
ετησίως	ετησιως
ετυμολογία	ετυμολογια
ευάλωτων	ευαλωτος
ευέλικτη	ευελικτος
ευέλικτο	ευελικτος
ευαίσθητες	ευαισθητος
ευαγγέλιο	ευαγγελιο
ευαγγελίστριας	ευαγγελιστρια
ευαισθητοποίησης	ευαισθητοποιηση
ευγηρίας	ευγηρια
ευγνώμων	ευγνωμων
ευελιξία	ευελιξια
ευελιξίας	ευελιξια
ευελπιστώ	ευελπιστω
ευεργετικό	ευεργετικος
ευημερίας	ευημερια
ευθέως	ευθεως
ευθείας	ευθεια
ευθυνών	ευθυνη
ευθύνες	ευθυνη
ευθύνη	ευθυνη
ευθύνη	ευθυνη
ευθύνονται	ευθυνομαι
ευθύτητα	ευθυτητα
ευκαιρία	ευκαιρια
ευκαιρίας	ευκαιρια
ευκαιρίες	ευκαιρια
ευλογήθηκε	ευλογω
ευνοηθεί	ευνοω
ευνοημένοι	ευνοω
ευνοημένων	ευνοω
ευνοούν	ευνοω
ευνοούνται	ευνοω
ευπαθών	ευπαθης
ευρέως	ευρεως
ευρεσιτεχνίας	ευρεσιτεχνια
ευρωζώνη	ευρωζωνη
ευρωκοινοβουλίου	ευρωκοινοβουλιο
ευρωμεσογειακή	ευρωμεσογειακος
ευρωπαίας	ευρωπαια
ευρωπαίες	ευρωπαια
ευρωπαίοι	ευρωπαιος
ευρωπαίους	ευρωπαιος
ευρωπαίους	ευρωπαιος
ευρωπαίων	ευρωπαιος
ευρωπαίοι	ευρωπαιος
ευρωπαίων	ευρωπαιος
ευρωπαϊκή	ευρωπαικος
ευρωπαϊκής	ευρωπαικος
ευρωπαϊκού	ευρωπαικος
ευρωπαϊκό	ευρωπαικος
ευρωπαϊκών	ευρωπαικος
ευρωπαϊκά	ευρωπαικος
ευρωπαϊκές	ευρωπαικος
ευρωπαϊκή	ευρωπαικος
ευρωπαϊκής	ευρωπαικος
ευρωπαϊκοί	ευρωπαικος
ευρωπαϊκού	ευρωπαικος
ευρωπαϊκό	ευρωπαικος
ευρωπαϊκών	ευρωπαικος
ευρωσκεπτικιστές	ευρωσκεπτικιστης
ευρεία	ευρυς
ευρείας	ευρυς
ευρύ	ευρυς
ευρύτατες	ευρυς
ευρύτερες	ευρυς
ευρύτερη	ευρυς
ευρύτερης	ευρυς
ευρύτερων	ευρυς
ευρώ	ευρω
ευρώπη	ευρωπη
ευρώπης	ευρωπη
ευτυχής	ευτυχης
ευχάριστο	ευχαριστος
ευχαρίστως	ευχαριστως
ευχαριστίες	ευχαριστια
ευχαριστώ	ευχαριστω
ευχαριστήσουμε	ευχαριστω
ευχαριστήσω	ευχαριστω
ευχαριστούμε	ευχαριστω
ευχαριστώ	ευχαριστω
ευχερή	ευχερης
εφετών	εφετης
εφαρμογή	εφαρμογη
εφαρμογής	εφαρμογη
εφαρμοστέες	εφαρμοστεος
εφαρμοστέους	εφαρμοστεος
εφαρμοστέων	εφαρμοστεος
εφαρμοσθεί	εφαρμοζω
εφαρμοσθούν	εφαρμοζω
εφαρμόζει	εφαρμοζω
εφαρμόζεται	εφαρμοζω
εφαρμόζονται	εφαρμοζω
εφαρμόσει	εφαρμοζω
εφαρμόσουμε	εφαρμοζω
εφαρμόσουν	εφαρμοζω
εφαρμόστηκε	εφαρμοζω
εφαρμόσιμη	εφαρμοσιμος
εφεδρικού	εφεδρικος
εφεξής	εφεξης
εφετείου	εφετειο
εφημέριος	εφημεριος
εφημερίδα	εφημεριδα
εφημερίδα	εφημεριδα
εφημερίδας	εφημεριδα
εφικτά	εφικτος
εφικτή	εφικτος
εφικτό	εφικτος
εφικτό	εφικτος
εφικτός	εφικτος
επιστήσω	εφιστω
εφιστά	εφιστω
εφιστώ	εφιστω
εφοδιασμό	εφοδιασμος
εφόδια	εφοδιο
εχέγγυα	εχεγγυος
εχέγγυα	εχεγγυος
εχεγγύων	εχεγγυος
εχθρικές	εχθρικος
εχθρών	εχθρος
εχθρότητά	εχθροτητα
εχθρότητα	εχθροτητα
ευελπίδων	ευελπις
εύκολα	ευκολα
ευκολότερη	ευκολος
ευκολότερο	ευκολος
εύκολη	ευκολος
εύκολο	ευκολος
εύλογη	ευλογος
εύρεσης	ευρεση
ευρήματα	ευρημα
εύρος	ευρος
εύστοχα	ευστοχα
εύφορης	ευφορος
ευχόμαστε	ευχομαι
ευχηθούμε	ευχομαι
ευχόμαστε	ευχομαι
ζάβια	ζαβια
ζέρβα	ζερβας
ζέρη	ζερη
ζήλο	ζηλος
ζήλος	ζηλος
ζήτημα	ζητημα
ζήτημα	ζητημα
ζητήματα	ζητημα
ζητήματος	ζητημα
ζητημάτων	ζητημα
ζήτησης	ζητηση
ζίνζιμπαρ	ζινζιμπαρ
ζαΐμη	ζαιμης
ζαν	ζαν
ζαϊμη	ζαιμης
ζεματίστρα	ζεματιστρα
ζενίτ	ζενιτ
ζημιές	ζημια
ζητούμενο	ζητουμενος
ζητωκραυγές	ζητωκραυγη
ζητώ	ζητω
ζήτησαν	ζητω
ζήτησε	ζητω
ζητά	ζητω
ζητάμε	ζητω
ζητήσει	ζητω
ζητήσουμε	ζητω
ζητούν	ζητω
ζητώ	ζητω
ζοφερό	ζοφερος
ζυγό	ζυγος
ζει	ζω
ζουν	ζω
ζούμε	ζω
ζωή	ζωη
ζωής	ζωη
ζωικά	ζωικος
ζωντανέψουν	ζωντανευω
ζωντανές	ζωντανος
ζωντανή	ζωντανος
ζωντανοί	ζωντανος
ζωντανό	ζωντανος
ζωτικής	ζωτικος
ζωτικό	ζωτικος
ζωνών	ζωνη
ζώνες	ζωνη
ζώνη	ζωνη
ζώνης	ζωνη
ζώα	ζωο
ζώων	ζωο
ηγέτες	ηγετης
ηγέτες	ηγετης
ηγέτη	ηγετης
ηγέτης	ηγετης
ηγέτης	ηγετης
ηγετών	ηγετης
ηγεσία	ηγεσια
ηγεσίας	ηγεσια
ηγετικά	ηγετικος
ηγετικό	ηγετικος
ηγουμενίτσα	ηγουμενιτσα
ηλεκτρικό	ηλεκτρικος
ηλεκτρικό	ηλεκτρικος
ηλεκτρονικά	ηλεκτρονικα
ηλεκτρονικής	ηλεκτρονικος
ηλεκτρονικού	ηλεκτρονικος
ηλεκτρονικό	ηλεκτρονικος
ηλεκτρονικών	ηλεκτρονικος
ηλικία	ηλικια
ηλικίας	ηλικια
ηλικίας	ηλικια
ηλικιωμένων	ηλικιωμενος
ηλιοβασίλεμα	ηλιοβασιλεμα
ημέρα	ημερα
ημέρας	ημερα
ημέρα	ημερα
ημέρας	ημερα
ημέρες	ημερα
ημίχρονο	ημιχρονο
ημιχρόνου	ημιχρονο
ημεδαποί	ημεδαπος
ημερήσια	ημερησιος
ημερομηνία	ημερομηνια
ημιαυτονομίας	ημιαυτονομια
ημιερειπωμένα	ημιερειπωμενος
ημισελήνου	ημισεληνος
ηνωμένα	ηνωμενος
ηνωμένες	ηνωμενος
ηνωμένο	ηνωμενος
ηνωμένου	ηνωμενος
ηνωμένων	ηνωμενος
ηπειρωτικά	ηπειρωτικος
ηραίου	ηραιο
ηρεμία	ηρεμια
ηττήθηκε	ηττωμαι
ηφαίστειο	ηφαιστειο
ηφαιστείου	ηφαιστειο
θάλασσα	θαλασσα
θάλασσας	θαλασσα
θάλασσα	θαλασσα
θάλασσας	θαλασσα
θαλασσών	θαλασσα
θάνατο	θανατος
θάνατος	θανατος
θανάτου	θανατος
θανάτους	θανατος
θάσιου	θασιος
θάσο	θασος
θέα	θεα
θέατρο	θεατρο
θέληση	θεληση
θέλουμε	θελω
θέλω	θελω
ήθελα	θελω
ήθελαν	θελω
ήθελε	θελω
θέλαμε	θελω
θέλει	θελω
θέλουμε	θελω
θέλουν	θελω
θέλω	θελω
θεμάτων	θεμα
θέμα	θεμα
θέματα	θεμα
θέματος	θεμα
θεμάτων	θεμα
θέρετρα	θερετρο
θέσεις	θεση
θέσεων	θεση
θέσεών	θεση
θέση	θεση
θέσης	θεση
θέσπιση	θεσπιση
τέθηκε	θετω
έθεσε	θετω
θέσει	θετω
θέσουμε	θετω
θέτει	θετω
θέτοντας	θετω
θέτουμε	θετω
θέτουν	θετω
τέθηκαν	θετω
τέθηκε	θετω
τίθεται	θετω
τεθεί	θετω
τεθούν	θετω
έθιξε	θιγω
θιγεί	θιγω
θαλάσσιο	θαλασσιος
θαλάσσια	θαλασσιος
θαλάσσιες	θαλασσιος
θαλάσσιο	θαλασσιος
θαλάσσιων	θαλασσιος
θαμνοκυπάρισσο	θαμνοκυπαρισσο
θανάσιμο	θανασιμος
θανατηφόρας	θανατηφορος
θανατηφόρων	θανατηφορος
θανατικής	θανατικος
θανατοποινίτες	θανατοποινιτης
θανάτωσε	θανατωνω
θαυμάζει	θαυμαζω
θαυμάσετε	θαυμαζω
θαυμάσια	θαυμασιος
θείο	θειος
θεαματικές	θεαματικος
θεμέλια	θεμελιο
θεματική	θεματικος
θεματοφύλακα	θεματοφυλακας
θεματοφύλακας	θεματοφυλακας
θεμελιωδών	θεμελιωδης
θεμελιώδες	θεμελιωδης
θεολόγου	θεολογος
θερίζετε	θεριζω
θερίζουμε	θεριζω
θερίσετε	θεριζω
θεραπεύτηκε	θεραπευω
θερμά	θερμα
θερμοκρασίες	θερμοκρασια
θερμότερες	θερμος
θεσμικά	θεσμικος
θεσμικό	θεσμικος
θεσμοθετήσετε	θεσμοθετω
θεσμών	θεσμος
θέσπισε	θεσπιζω
θεσπίσθηκε	θεσπιζω
θεσπίσουμε	θεσπιζω
θεσπιστούν	θεσπιζω
θεσπρωτίας	θεσπρωτια
θεσσαλικό	θεσσαλικος
θεσσαλονίκης	θεσσαλονικη
θετική	θετικος
θετικά	θετικος
θετικές	θετικος
θετική	θετικος
θετικής	θετικος
θετικό	θετικος
θετικών	θετικος
θεωρητικά	θεωρητικα
θεωρείται	θεωρω
θεωρούμε	θεωρω
θεωρώ	θεωρω
θεωρήθηκε	θεωρω
θεωρήσει	θεωρω
θεωρήσουμε	θεωρω
θεωρεί	θεωρω
θεωρείται	θεωρω
θεωρείτε	θεωρω
θεωρηθεί	θεωρω
θεωρηθούν	θεωρω
θεωρούμε	θεωρω
θεωρούν	θεωρω
θεωρούνται	θεωρω
θεωρούσε	θεωρω
θεωρώ	θεωρω
θεωρώντας	θεωρω
θεώρησα	θεωρω
θεώρησαν	θεωρω
θεώρησε	θεωρω
θεόδωρο	θεοδωρος
θεών	θεος
θεώρηση	θεωρηση
θεώρησης	θεωρηση
θητεία	θητεια
θητείας	θητεια
θιβέτ	θιβετ
θιβετιανοί	θιβετιανος
θιβετιανού	θιβετιανος
θιβετιανούς	θιβετιανος
θιβετιανών	θιβετιανος
θιβετιανή	θιβετιανος
θνησιμότητας	θνησιμοτητα
θορυβηθεί	θορυβω
θράκη	θρακη
θρακών	θρακος
θρασύβουλο	θρασυβουλος
θρησκεία	θρησκεια
θρησκείας	θρησκεια
θρησκευτική	θρησκευτικος
θρησκευτικούς	θρησκευτικος
θριαμβευτική	θριαμβευτικος
θρόμβο	θρομβος
θρόνο	θρονος
θυελλώδεις	θυελλωδης
θυμούνται	θυμαμαι
θυμίζουμε	θυμιζω
θύμισε	θυμιζω
θυσία	θυσια
θυσιάσουν	θυσιαζω
θωρηκτό	θωρηκτο
θορύβου	θορυβος
θόρυβος	θορυβος
θύελλα	θυελλα
θυλάκων	θυλακας
θυμάτων	θυμα
θύματα	θυμα
ιάτσιν	ιατσιν
ιανουάριο	ιανουαριο
ιανουαρίου	ιανουαριος
ιανουαρίου	ιανουαριος
ιαπωνικές	ιαπωνικος
ιαπωνικό	ιαπωνικος
ιατρείο	ιατρειο
ιατρικές	ιατρικος
ιατρικός	ιατρικος
ιατρικό	ιατρικος
ιατροφαρμακευτικής	ιατροφαρμακευτικος
ιβάν	ιβαν
ιδέα	ιδεα
ιδέας	ιδεα
ιδέες	ιδεα
ιδίως	ιδιως
ιδανικό	ιδανικο
ιδανική	ιδανικος
ιδανικό	ιδανικος
ιδεολογία	ιδεολογια
ιδιαίτερα	ιδιαιτερα
ιδιαίτερα	ιδιαιτερα
ιδιαιτέρως	ιδιαιτερα
ιδιαίτερα	ιδιαιτερος
ιδιαίτερη	ιδιαιτερος
ιδιοκτήτες	ιδιοκτητης
ιδιοκτήτη	ιδιοκτητης
ιδιωτεύσει	ιδιωτευω
ιδιωτικοποιούμε	ιδιωτικοποιω
ιδιωτικά	ιδιωτικος
ιδιωτικές	ιδιωτικος
ιδιωτική	ιδιωτικος
ιδιότητά	ιδιοτητα
ιδιότητα	ιδιοτητα
ιδιώτες	ιδιωτης
ίδρυσαν	ιδρυω
ιδρυθεί	ιδρυω
ιδρύει	ιδρυω
ιδρύεται	ιδρυω
ιδρύθηκαν	ιδρυω
ιδρύθηκε	ιδρυω
ιδρύοντας	ιδρυω
ιδρύουν	ιδρυω
ιδρύσουν	ιδρυω
ιεραρχήσουμε	ιεραρχω
ιεροδιδασκαλείων	ιεροδιδασκαλειο
ιερομόναχος	ιερομοναχος
ιερού	ιερο
ιερά	ιερος
ιεράς	ιερος
ιερή	ιερος
ιερό	ιερος
ιερός	ιερος
ιερά	ιερος
ιερό	ιερος
ιερό	ιερος
ιθύνων	ιθυνων
ικέρ	ικερ
ικανοποίησή	ικανοποιηση
ικανοποίηση	ικανοποιηση
ικανοποιητικό	ικανοποιητικος
ικανοποιητικός	ικανοποιητικος
ικανοποιεί	ικανοποιω
ικανοποιημένη	ικανοποιω
ικανοποιημένοι	ικανοποιω
ικανή	ικανος
ικανότητά	ικανοτητα
ικανότητα	ικανοτητα
ικανότητας	ικανοτητα
ιλ	ιλ
ιλιά	ιλια
ιλλινόις	ιλλινοις
ινδικής	ινδικος
ινστιτούτου	ινστιτουτο
ιντιάνα	ιντιανα
ιουλίου	ιουλιος
ιούλιο	ιουλιος
ιούλιο	ιουλιος
ιουνίου	ιουνιος
ιούνιο	ιουνιος
ιππασία	ιππασια
ιράν	ιραν
ιρανική	ιρανικος
ισημερινό	ισημερινος
ισλαμικό	ισλαμικος
ισλαμικών	ισλαμικος
ισλαμιστές	ισλαμιστης
ισλαμιστών	ισλαμιστης
ισοδυναμεί	ισοδυναμω
ισοπαλία	ισοπαλια
ισοπέδωσαν	ισοπεδωνω
ισορροπία	ισορροπια
ισορροπημένο	ισορροπημενος
ισοφάρισαν	ισοφαριζω
ισοφαρίσουν	ισοφαριζω
ισπανική	ισπανικος
ισπανικής	ισπανικος
ισπανούς	ισπανος
ισραηλινών	ισραηλινη
ισραηλινή	ισραηλινος
ισραηλινούς	ισραηλινος
ισραηλοαμερικανική	ισραηλοαμερικανικη
ιστορίας	ιστορια
ιστορία	ιστορια
ιστορίας	ιστορια
ιστορική	ιστορικος
ιστορικού	ιστορικος
ιστορικούς	ιστορικος
ιστορικό	ιστορικος
ιστορικών	ιστορικος
ισχυρίζομαι	ισχυριζομαι
ισχυρίζονται	ισχυριζομαι
ισχυρίστηκε	ισχυριζομαι
ισχυροποίηση	ισχυροποιηση
ισχυροί	ισχυρος
ισχυρές	ισχυρος
ισχυρή	ισχυρος
ισχυρούς	ισχυρος
ισχυρό	ισχυρος
ισχυρότατα	ισχυρος
ισχυρότερη	ισχυρος
ισχυρών	ισχυρος
ισχύ	ισχυς
ισχύος	ισχυς
ίσχυαν	ισχυω
ισχύει	ισχυω
ισχύουν	ισχυω
ισχύσει	ισχυω
ισχυουσών	ισχυων
ισχύον	ισχυων
ισχύοντες	ισχυων
ισχύοντος	ισχυων
ισχύουσας	ισχυων
ισχύουσες	ισχυων
ισόβια	ισοβια
ισόρροπες	ισορροπος
ισόρροπη	ισορροπος
ισότητα	ισοτητα
ισότιμη	ισοτιμος
ισότιμης	ισοτιμος
ιωάννη	ιωαννης
ιωάννης	ιωαννης
ιωάννου	ιωαννης
ιωαννίνων	ιωαννινα
ιόνιο	ιονιο
κάδων	καδος
κάθειρξη	καθειρξη
κάθειρξης	καθειρξη
κάθετη	καθετος
κάθετοι	καθετος
κάθετους	καθετος
κάθεται	καθομαι
καθίσουν	καθομαι
κάιντα	καιντα
κάλαχαν	καλαχαν
κάλπη	καλπη
κάμερα	καμερα
κάμπινγκ	καμπινγκ
κάμπο	καμπος
κάνσας	κανσας
έκαναν	κανω
έκανε	κανω
κάναμε	κανω
κάνατε	κανω
κάνει	κανω
κάνετε	κανω
κάνουμε	κανω
κάνουν	κανω
κάνω	κανω
κάποτε	καποτε
κάπου	καπου
κάπως	καπως
κάρτα	καρτα
κάστρο	καστρο
κάστρου	καστρο
κάτοικοι	κατοικος
κάτοικος	κατοικος
κατοίκους	κατοικος
κατοίκων	κατοικος
κάτοχος	κατοχος
κάτω	κατω
κάτω	κατω
κάτω	κατω
κατώτερα	κατω
κέδρους	κεδρος
κέντρο	κεντρο
κέντρα	κεντρο
κέντρο	κεντρο
κέντρου	κεντρο
κέρδη	κερδος
κέρι	κερι
κέρκυρα	κερκυρα
κήπους	κηπος
κίνας	κινα
κίνδυνο	κινδυνος
κίνδυνος	κινδυνος
κινδύνου	κινδυνος
κινδύνους	κινδυνος
κίνημα	κινημα
κινήματος	κινημα
κινημάτων	κινημα
κίνηση	κινηση
κίνησης	κινηση
κινήσεις	κινηση
κίνητρα	κινητρο
καΐκι	καικι
καΐκια	καικι
καίρια	καιριος
καίριο	καιριος
κάηκαν	καιω
καίγεται	καιω
καβάλα	καβαλα
καβάλας	καβαλα
καγιάκ	καγιακ
καθένας	καθενας
καθήκον	καθηκον
καθήκοντά	καθηκον
καθήκοντα	καθηκον
καθηκόντων	καθηκον
καθίσταται	καθισταμαι
κατέστη	καθισταμαι
καταστεί	καθισταμαι
καταστούν	καθισταμαι
καθαριότητας	καθαριοτητα
καθαρό	καθαρος
καθαρότερα	καθαρος
καθαυτή	καθεαυτος
καθαυτόν	καθεαυτος
καθεστωτική	καθεστωτικος
καθεστώς	καθεστως
καθεστώς	καθεστως
καθεστώτος	καθεστως
καθηλωμένα	καθηλωμενος
καθημερινά	καθημερινα
καθημερινή	καθημερινος
καθιέρωση	καθιερωση
καθιέρωσε	καθιερωνω
καθιερωθεί	καθιερωνω
καθιερωμένη	καθιερωνω
καθιερωνόταν	καθιερωνω
καθιερώθηκε	καθιερωνω
καθιερώσει	καθιερωνω
καθιστά	καθιστω
καθιστούσε	καθιστω
κατέστησε	καθιστω
καταστήσουμε	καθιστω
καθοδηγημένη	καθοδηγω
καθολικό	καθολικος
καθορίσαμε	καθοριζω
καθορίζει	καθοριζω
καθορίζεται	καθοριζω
καθορίσει	καθοριζω
καθορίσουν	καθοριζω
καθορίστηκε	καθοριζω
καθορισθεί	καθοριζω
καθοριστούν	καθοριζω
καθόριζαν	καθοριζω
καθορισμός	καθορισμος
καθοριστική	καθοριστικος
καθυστέρηση	καθυστερηση
καθυστερήσεις	καθυστερηση
καθυστερήσεων	καθυστερηση
καθυστέρησε	καθυστερω
καθυστερήσει	καθυστερω
καθυστερήσουν	καθυστερω
καθυστερεί	καθυστερω
καθυστερούν	καθυστερω
καθόλου	καθολου
καθώς	καθως
καινοτομίας	καινοτομια
καινοτομίες	καινοτομια
καινοτόμες	καινοτομος
καινούργιο	καινουργιος
καιρικά	καιρικος
καιρούς	καιρος
καιρό	καιρος
καιρός	καιρος
κακοκαιρίας	κακοκαιρια
κακές	κακος
χειρότερη	κακος
χειρότερο	κακος
χειρότερος	κακος
καλά	καλα
καλύτερα	καλα
καλδέριο	καλδεριο
καλλιέργειας	καλλιεργεια
καλλιέργησαν	καλλιεργω
καλλιεργείστε	καλλιεργω
καλλιεργούμε	καλλιεργω
καλλιτέχνη	καλλιτεχνης
καλογερόπουλο	καλογεροπουλος
καλογερόπουλου	καλογεροπουλος
καλοδεχούμενοι	καλοδεχουμενος
καλοκαίρι	καλοκαιρι
καλυβίδου	καλυβιδου
καλυμμένοι	καλυμμενος
καλωσορίζουμε	καλωσοριζω
καλωσορίσουμε	καλωσοριζω
καλωσορίστηκε	καλωσοριζω
καλωσόρισε	καλωσοριζω
καλή	καλος
καλές	καλος
καλή	καλος
καλό	καλος
καλύτερες	καλος
καλύτερη	καλος
καλύτερης	καλος
καλύτερο	καλος
καλύτερων	καλος
καλύπτεται	καλυπτω
καλύπτουν	καλυπτω
καλύψει	καλυπτω
καλύψουν	καλυπτω
καλώ	καλω
κάλεσε	καλω
καλέσω	καλω
καλεί	καλω
καλώ	καλω
καμάρες	καμαρα
καμπάνια	καμπανια
καμπλία	καμπλια
καν	καν
κανονικά	κανονικα
κανονικής	κανονικος
κανονισμού	κανονισμος
κανονισμούς	κανονισμος
κανονισμός	κανονισμος
κανονισμών	κανονισμος
κανονιστικού	κανονιστικος
κανονιστικών	κανονιστικος
καντάφι	κανταφι
καντούνια	καντουνι
καντόνι	καντονι
κανόνα	κανονας
κανόνας	κανονας
κανόνες	κανονας
κανόνων	κανονας
κανόνι	κανονι
κανόνια	κανονι
καπιτώλιο	καπιτωλιο
καπνοχώρι	καπνοχωρι
καραβάκια	καραβακι
καραμανλή	καραμανλης
καραϊσκάκης	καραισκακης
καρδιαγγειακές	καρδιαγγειακος
καρζάι	καρζαι
καρκίνου	καρκινος
καρκίνο	καρκινος
καρκίνος	καρκινος
καρκινογόνες	καρκινογονος
καρκινογόνο	καρκινογονος
καρπός	καρπος
καστανιές	καστανια
κατάγομαι	καταγομαι
καταδύσεις	καταδυση
καταθέσεις	καταθεση
καταθέσεων	καταθεση
κατακτήσεις	κατακτηση
κατάλληλες	καταλληλος
κατάλληλο	καταλληλος
κατάλληλος	καταλληλος
κατάλληλους	καταλληλος
κατάλογος	καταλογος
καταλόγου	καταλογος
κατάπαυση	καταπαυση
κατάπαυσης	καταπαυση
κατάργηση	καταργηση
κατάρρευση	καταρρευση
κατάρτιση	καταρτιση
κατάρτισης	καταρτιση
καταστάσεων	κατασταση
κατάστασή	κατασταση
κατάσταση	κατασταση
κατάστασης	κατασταση
καταστάσεις	κατασταση
κατασχέθηκαν	κατασχω
κατάταξη	καταταξη
κατάφυτο	καταφυτος
κατάφωρο	καταφωρος
κατάχρηση	καταχρηση
καταχρήσεις	καταχρηση
καταχρήσεων	καταχρηση
κατέχει	κατεχω
κατέχουν	κατεχω
κατείχαν	κατεχω
κατείχε	κατεχω
καταβάλει	καταβαλλω
καταβάλλεται	καταβαλλω
καταβάλλουν	καταβαλλω
καταβάλουμε	καταβαλλω
καταβληθούν	καταβαλλω
καταβολή	καταβολη
καταγάλανα	καταγαλανος
κατήγγειλε	καταγγελλω
καταγγέλλουν	καταγγελλω
καταγγελίας	καταγγελια
καταγγελίες	καταγγελια
καταγεγγραμένο	καταγεγγραμενο
καταγράφονται	καταγραφω
καταγωγή	καταγωγη
καταγωγής	καταγωγη
κατέδειξε	καταδεικνυω
καταδείξει	καταδεικνυω
καταδείξουν	καταδεικνυω
καταδεικνύεται	καταδεικνυω
καταδίκασε	καταδικαζω
καταδικάζονται	καταδικαζω
καταδικάζουμε	καταδικαζω
καταδικάσει	καταδικαζω
καταδικάστηκαν	καταδικαζω
καταδικάστηκε	καταδικαζω
καταδικαστεί	καταδικαζω
καταδιώκουν	καταδιωκω
καταζητούνταν	καταζητω
καταθέτες	καταθετης
κατέθεσαν	καταθετω
κατέθεσε	καταθετω
καταθέσεις	καταθετω
καταθέτοντας	καταθετω
κατακλείδι	κατακλειδι
κατακλυσθεί	κατακλυζω
κατέκρινε	κατακρινω
κατακρίνουμε	κατακρινω
κατακτητές	κατακτητης
κατακτητή	κατακτητης
κατέληξαν	καταληγω
κατέληξε	καταληγω
καταλήγω	καταληγω
καταλήξαμε	καταληγω
καταλήξει	καταληγω
καταλήξετε	καταληγω
καταλήξουμε	καταληγω
καταλήξουν	καταληγω
κατέλαβαν	καταλαβαινω
καταλάβουμε	καταλαβαινω
καταλαμβάνει	καταλαμβανω
καταλαμβάνοντας	καταλαμβανω
καταληκτική	καταληκτικος
καταλυτικό	καταλυτικος
καταμετρημένο	καταμετρημενος
κατανάλωση	καταναλωση
κατανάλωσης	καταναλωση
καταναλωτών	καταναλωτης
καταναλωτές	καταναλωτης
καταναλωτή	καταναλωτης
κατανομή	κατανομη
κατανοήσει	κατανοω
κατανοήσουμε	κατανοω
κατανοώ	κατανοω
κατανόησης	κατανοηση
καταπίεση	καταπιεση
καταπολέμηση	καταπολεμηση
καταπολέμησης	καταπολεμηση
καταπολεμήσει	καταπολεμω
καταπολεμήσουμε	καταπολεμω
καταπράσινα	καταπρασινος
καταπράσινο	καταπρασινος
καταργήθηκε	καταργω
καταργήσουμε	καταργω
κατέρρευσαν	καταρρεω
καταρτίσει	καταρτιζω
καταρχάς	καταρχας
καταρχάς	καταρχας
καταρχήν	καταρχην
κατασκηνώσεις	κατασκηνωση
κατασκευή	κατασκευη
κατασκευής	κατασκευη
κατασκευαστές	κατασκευαστης
κατασκευαστή	κατασκευαστης
κατασκευαστής	κατασκευαστης
κατασκευαστικών	κατασκευαστικος
κατασκηνωτικό	κατασκηνωτικο
κατασταλτικά	κατασταλτικος
κατασταλτικές	κατασταλτικος
καταστατικό	καταστατικο
καταστολή	καταστολη
καταστολής	καταστολη
κατέστρεψαν	καταστρεφω
καταστρέφουν	καταστρεφω
καταστρέψει	καταστρεφω
καταστραφούν	καταστρεφω
κατεστραμμένης	καταστρεφω
καταστρεπτικές	καταστρεπτικος
καταστροφές	καταστροφη
καταστροφή	καταστροφη
καταστροφής	καταστροφη
καταστροφών	καταστροφη
καταστροφικός	καταστροφικος
κατατάξει	κατατασσω
καταταχθεί	κατατασσω
κατάφεραν	καταφερνω
κατάφερε	καταφερνω
καταφέρει	καταφερνω
καταφέρουμε	καταφερνω
καταφέρουν	καταφερνω
κατέφυγαν	καταφευγω
καταφύγιο	καταφυγιο
καταχωρούνται	καταχωρω
καταψήφιση	καταψηφιση
καταψηφίσει	καταψηφιζω
καταψηφίσουμε	καταψηφιζω
κατευθυντήριες	κατευθυντηριος
κατηύθυνε	κατευθυνω
κατεχόμενες	κατεχομενος
κατευθύνσεις	κατευθυνση
κατεύθυνση	κατευθυνση
κατηγορία	κατηγορια
κατηγορίες	κατηγορια
κατηγοριών	κατηγορια
κατηγορούμενο	κατηγορουμενος
κατηγορούμενοι	κατηγορουμενος
κατηγορήθηκαν	κατηγορω
κατηγόρησαν	κατηγορω
κατηγόρησε	κατηγορω
κατοικία	κατοικια
κατοικίας	κατοικια
κατοικίες	κατοικια
κατοικούν	κατοικω
κατονομάσω	κατονομαζω
κατοπινή	κατοπινος
κατοπινός	κατοπινος
κατορθώσει	κατορθωνω
κατόρθωνε	κατορθωνω
κατοχής	κατοχη
κατοχή	κατοχη
κατοχής	κατοχη
κατοχική	κατοχικος
κατσάδιαζε	κατσαδιαζω
κατσώνης	κατσωνης
κατώφλια	κατωφλι
κατωφλίου	κατωφλιο
κατωφλίων	κατωφλιο
καυσαέρια	καυσαεριο
καυσαερίων	καυσαεριο
καφετέριες	καφετερια
καύκασο	καυκασος
καύκασος	καυκασος
καυσίμων	καυσιμο
καύσιμα	καυσιμο
κείμενα	κειμενο
κείμενο	κειμενο
κειμένου	κειμενο
κειμένων	κειμενο
κείμενο	κειμενος
κειμήλια	κειμηλιο
κελιά	κελι
κεντρική	κεντρικος
κεντρικής	κεντρικος
κεντρικά	κεντρικος
κεντρικές	κεντρικος
κεντρική	κεντρικος
κεντρικοί	κεντρικος
κεντρικούς	κεντρικος
κεντρικό	κεντρικος
κεντρικών	κεντρικος
κεντρώας	κεντρωος
κενά	κενο
κενό	κενο
κεριά	κερι
κέρδισε	κερδιζω
κερδίσει	κερδιζω
κερδίσουμε	κερδιζω
κερδισμένοι	κερδιζω
κερδοσκοπική	κερδοσκοπικος
κερύνεια	κερυνεια
κερύνειας	κερυνεια
κεφάλαιο	κεφαλαιο
κεφαλαίου	κεφαλαιο
κεφαλαίων	κεφαλαιο
κεφαλή	κεφαλη
κεφαλιά	κεφαλια
κηλίδωνε	κηλιδωνω
κήρυξε	κηρυσσω
κηρυχθεί	κηρυσσω
κηρύξει	κηρυσσω
κηρύχτηκε	κηρυσσω
κι	κι
κιμ	κιμ
κινέζικη	κινεζικος
κινέζοι	κινεζος
κινέζους	κινεζος
κινδυνεύουν	κινδυνευω
κινεζικά	κινεζικος
κινεζικό	κινεζικος
κινεζικού	κινεζικος
κινεζικό	κινεζικος
κινηματογράφο	κινηματογραφος
κινητήρα	κινητηρας
κινητικότητα	κινητικοτητα
κινητικότητας	κινητικοτητα
κινητοποίηση	κινητοποιηση
κινητοποιήσεις	κινητοποιηση
κινητή	κινητος
κινήθηκαν	κινω
κινείται	κινω
κινούν	κινω
κινούνται	κινω
κισίντα	κισιντα
κλάδο	κλαδος
κλάδος	κλαδος
κλάδου	κλαδος
κλάδων	κλαδος
κλίβανος	κλιβανος
κλίμα	κλιμα
κλίματος	κλιμα
κλίμακα	κλιμακα
κλίμακας	κλιμακα
κλίντον	κλιντον
κλασικών	κλασικος
κλασσικά	κλασσικος
έκλεισαν	κλεινω
κλείνουμε	κλεινω
κλείνω	κλεινω
κλείσετε	κλεινω
κλείσω	κλεινω
κλείσιμο	κλεισιμο
κλεισίματος	κλεισιμο
κλειδί	κλειδι
κλειστό	κλειστος
κληρίδης	κληριδης
κληρικών	κληρικος
κληροδοτήσουμε	κληροδοτω
κληρονομιά	κληρονομια
κλιματικούς	κλιματικος
κλπ.	κλπ
κλώντ	κλωντ
κοιτάσματα	κοιτασμα
κοιλάδα	κοιλαδα
κοιλάδες	κοιλαδα
κοινοβουλευτική	κοινοβουλευτικος
κοινοβουλευτικής	κοινοβουλευτικος
κοινοβουλευτικού	κοινοβουλευτικος
κοινοβουλευτικό	κοινοβουλευτικος
κοινοβουλευτικών	κοινοβουλευτικος
κοινοβουλίου	κοινοβουλιο
κοινοβούλιο	κοινοβουλιο
κοινοβούλιο	κοινοβουλιο
κοινοβουλίου	κοινοβουλιο
κοινοβουλίων	κοινοβουλιο
κοινοβούλια	κοινοβουλιο
κοινοβούλιο	κοινοβουλιο
κοινοποίηση	κοινοποιηση
κοινοποίησης	κοινοποιηση
κοινοπραξιών	κοινοπραξια
κοινοτικά	κοινοτικος
κοινοτική	κοινοτικος
κοινοτικής	κοινοτικος
κοινοτικού	κοινοτικος
κοινοτικό	κοινοτικος
κοινοτικών	κοινοτικος
κοινωνία	κοινωνια
κοινωνίας	κοινωνια
κοινωνικά	κοινωνικα
κοινωνικών	κοινωνικος
κοινωνικά	κοινωνικος
κοινωνικά	κοινωνικος
κοινωνικές	κοινωνικος
κοινωνική	κοινωνικος
κοινωνικής	κοινωνικος
κοινωνικούς	κοινωνικος
κοινωνικό	κοινωνικος
κοινωνικός	κοινωνικος
κοινωνικών	κοινωνικος
κοινού	κοινο
κοινό	κοινο
κοινή	κοινος
κοινής	κοινος
κοινά	κοινος
κοινή	κοινος
κοινής	κοινος
κοινό	κοινος
κοινών	κοινος
κοινότητα	κοινοτητα
κοινότητας	κοινοτητα
κοινοτήτων	κοινοτητα
κοινότητα	κοινοτητα
κοινότητες	κοινοτητα
κοιτάζουμε	κοιταζω
κολοκοτρώνη	κολοκοτρωνης
κολυμπήσετε	κολυμπω
κολύμπι	κολυμπι
κομμάτι	κομματι
κομματικά	κομματικος
κομματική	κομματικος
κομμουνισμού	κομμουνισμος
κομμουνιστές	κομμουνιστης
κομμουνιστές	κομμουνιστης
κομμουνιστικά	κομμουνιστικα
κομμουνιστικής	κομμουνιστικος
κομμουνιστικό	κομμουνιστικος
κομμουνιστικά	κομμουνιστικος
κομμουνιστικές	κομμουνιστικος
κομμουνιστικού	κομμουνιστικος
κομοτηνή	κομοτηνη
κομουνισμό	κομουνισμος
κομουνιστές	κομουνιστης
κομουνιστή	κομουνιστης
κομουνιστής	κομουνιστης
κομουνιστής	κομουνιστης
κομπίνες	κομπινα
κονγκολέζων	κονγκολεζος
κονδυλίων	κονδυλιο
κοντά	κοντα
κοντύτερα	κοντα
κοντινά	κοντινος
κοντινή	κοντινος
κοντινό	κοντινος
κοπεγχάγης	κοπεγχαγη
κοπτικής	κοπτικος
κορέα	κορεα
κορέας	κορεα
κορίνθιους	κορινθιος
κορίτσια	κοριτσι
κοριννός	κοριννος
κορυφής	κορυφη
κορυφών	κορυφη
κορυφές	κορυφη
κορυφή	κορυφη
κορυφής	κορυφη
κορυφαίος	κορυφαιος
κορυφώνεται	κορυφωνω
κορφού	κορφου
κοσμικού	κοσμικος
κοστίζει	κοστιζω
κουανγκτόνγκ	κουανγκτονγκ
κουβέρτες	κουβερτα
κουβανικές	κουβανικος
κουβανική	κουβανικος
κουβανικής	κουβανικος
κουβανικών	κουβανικος
κουβανοί	κουβανος
κουβανούς	κουβανος
κουβανό	κουβανος
κουκουναριές	κουκουναρια
κουκουναριές	κουκουναρια
κουκουναριών	κουκουναρια
κουκουναριές	κουκουναρια
κουλτούρα	κουλτουρα
κουντ	κουντ
κουντουριώτη	κουντουριωτης
κουρσάρους	κουρσαρος
κούβα	κουβα
κούβας	κουβα
κούνια	κουνια
κούραση	κουραση
κούρος	κουρος
κράτησης	κρατηση
κρατήσεις	κρατηση
κράτους	κρατος
κράτη	κρατος
κράτος	κρατος
κράτους	κρατος
κρατών	κρατος
έκρινε	κρινω
κρίθηκε	κρινω
κρίνει	κρινω
κρίνουμε	κρινω
κρίση	κριση
κρίσης	κριση
κρίσιμες	κρισιμος
κρίσιμη	κρισιμος
κρίστιαν	κριστιαν
κρανίου	κρανιο
κρατίδια	κρατιδιο
κρατικοποίηση	κρατικοποιηση
κρατικού	κρατικος
κρατικά	κρατικος
κρατικές	κρατικος
κρατικού	κρατικος
κρατικό	κρατικος
κρατικών	κρατικος
κρατουμένων	κρατουμενος
κρατούμενοι	κρατουμενος
κρατούμενος	κρατουμενος
κρατούμενους	κρατουμενος
κράτησαν	κρατω
κράτησε	κρατω
κρατούσαν	κρατω
κρατούσε	κρατω
κραυγών	κραυγη
κρεμλίνο	κρεμλινο
κρεμασμένο	κρεμω
κρηνίδες	κρηνιδες
κρητική	κρητικη
κρητικοί	κρητικος
κρητικού	κρητικος
κρητικούς	κρητικος
κρητικών	κρητικος
κρητική	κρητικος
κρητικό	κρητικος
κριμαϊκού	κριμαικος
κριτήρια	κριτηριο
κριτήριο	κριτηριο
κριτηρίου	κριτηριο
κριτηρίων	κριτηριο
κριτική	κριτικη
κριτική	κριτικη
κριτικής	κριτικη
κρούσματα	κρουσμα
έκρυβε	κρυβω
κτίστηκε	κτιζω
κτίρια	κτιριο
κτίριο	κτιριο
κτιρίου	κτιριο
κτιρίων	κτιριο
κτίσμα	κτισμα
κτίσματα	κτισμα
κτισμάτων	κτισμα
κτελ	κτελ
κτιριακό	κτιριακος
κεκτημένου	κτωμαι
κυβέρνηση	κυβερνηση
κυβέρνησης	κυβερνηση
κυβέρνησή	κυβερνηση
κυβέρνηση	κυβερνηση
κυβέρνησης	κυβερνηση
κυβερνήσεις	κυβερνηση
κυβερνήσεων	κυβερνηση
κυβερνήτης	κυβερνητης
κυβερνητικές	κυβερνητικος
κυβερνητικού	κυβερνητικος
κυβερνητικών	κυβερνητικος
κυκλαδίτικη	κυκλαδιτικος
κυκλαδίτικο	κυκλαδιτικος
κυκλοφορία	κυκλοφορια
κυκλοφοριακή	κυκλοφοριακος
κυκλοφορούν	κυκλοφορω
κυκλοφορούντων	κυκλοφορων
κύκλωσαν	κυκλωνω
κυλά	κυλω
κυνήγι	κυνηγι
κυπριακής	κυπριακος
κυπριακού	κυπριακος
κυπριακών	κυπριακος
κυρά	κυρα
κυρία	κυρια
κυρίες	κυρια
κυρία	κυρια
κυρίας	κυρια
κυρίες	κυρια
κυρίως	κυριως
κυριακάτικη	κυριακατικος
κυριακή	κυριακη
κυριαρχία	κυριαρχια
κυριαρχίας	κυριαρχια
κυριαρχεί	κυριαρχω
κυριαρχούν	κυριαρχω
κυριολεξία	κυριολεξια
κυρώσει	κυρωνω
κυτίο	κυτιο
κωδικογράφων	κωδικογραφος
κωδικό	κωδικος
κωνσταντίνο	κωνσταντινος
κωνσταντίνος	κωνσταντινος
κωνσταντινούπολης	κωνσταντινουπολη
έκοψαν	κοβω
κόγχη	κογχη
κόκκινα	κοκκινος
κόκκινη	κοκκινος
κόκκινους	κοκκινος
κόλπο	κολπο
κόλπο	κολπος
κόλπο	κολπος
κόμμα	κομμα
κόμματος	κομμα
κομμάτων	κομμα
κόμματα	κομμα
κόμματος	κομμα
κόπο	κοπος
κόπτες	κοπτης
κόσμου	κοσμος
κόσμο	κοσμος
κόσμος	κοσμος
κόστος	κοστος
κόστους	κοστος
κύκλο	κυκλος
κύκλος	κυκλος
κύκλους	κυκλος
κύκλωμα	κυκλωμα
κύκνοι	κυκνος
κύμα	κυμα
κύματα	κυμα
κυπρίων	κυπριος
κύπρο	κυπρος
κύπρος	κυπρος
κύπρου	κυπρος
κύριε	κυριος
κυρίους	κυριος
κυρίων	κυριος
κυριότερους	κυριος
κύρια	κυριος
κύριε	κυριος
κύριες	κυριος
κύριο	κυριος
κύριοι	κυριος
κύριοι	κυριος
κύριος	κυριος
κυρώσεις	κυρωση
κυρώσεων	κυρωση
κυρώσεών	κυρωση
κυττάρων	κυτταρο
κώδικα	κωδικας
κώδικας	κωδικας
κώδικες	κωδικας
κώμη	κωμη
λάδια	λαδι
λάθη	λαθος
λάθος	λαθος
λάμα	λαμα
λάμπρος	λαμπρος
λάντεν	λαντεν
λάτρεις	λατρης
έλεγα	λεγω
είπαν	λεγω
είπατε	λεγω
είπε	λεγω
ειπωθεί	λεγω
λέγοντας	λεγω
λέει	λεγω
λέμε	λεγω
λένε	λεγω
πει	λεγω
πουν	λεγω
πούμε	λεγω
πω	λεγω
λέξη	λεξη
έληξε	ληγω
λήγει	ληγω
λήξη	ληξη
λήψη	ληψη
λήψης	ληψη
λίγο	λιγο
ελάχιστα	λιγο
λίγο	λιγο
λιγότερο	λιγο
λίγα	λιγος
λίγες	λιγος
λίγο	λιγος
λίγων	λιγος
λιγότερα	λιγος
λιγότερες	λιγος
λιγότερης	λιγος
λίθο	λιθος
λιμνών	λιμνη
λίμνες	λιμνη
λίμνη	λιμνη
λίνδου	λινδος
λίον	λιον
λίστα	λιστα
λαβρόφ	λαβροφ
λαθρεμπόριο	λαθρεμποριο
έλαβα	λαμβανω
έλαβε	λαμβανω
ελήφθη	λαμβανω
λάβαμε	λαμβανω
λάβατε	λαμβανω
λάβει	λαμβανω
λάβετε	λαμβανω
λάβουμε	λαμβανω
λάβουν	λαμβανω
λάβω	λαμβανω
λήφθηκαν	λαμβανω
λαμβάνει	λαμβανω
λαμβάνεται	λαμβανω
λαμβάνονται	λαμβανω
λαμβάνοντας	λαμβανω
λαμβάνουμε	λαμβανω
ληφθεί	λαμβανω
λατινική	λατινικος
λατινικό	λατινικος
λατομεία	λατομειο
λατρεία	λατρεια
λατρείας	λατρεια
λατρευτική	λατρευτικος
λαφυραγωγούσε	λαφυραγωγω
λαϊκισμού	λαικισμος
λαϊκή	λαικος
λαϊκής	λαικος
λαϊκό	λαικος
λαϊκός	λαικος
λαοί	λαος
λαού	λαος
λαούς	λαος
λαό	λαος
λαό	λαος
λαός	λαος
λαών	λαος
λε	λε
λείπει	λειπω
λείψει	λειπω
λεγόμενες	λεγομενος
λεγόμενη	λεγομενος
λεγόμενο	λεγομενος
λεγόμενος	λεγομενος
λεγόμενους	λεγομενος
λεγόμενων	λεγομενος
λειτουργία	λειτουργια
λειτουργίας	λειτουργια
λειτουργίες	λειτουργια
λειτουργιών	λειτουργια
λειτουργήσει	λειτουργω
λειτουργεί	λειτουργω
λειτουργούμε	λειτουργω
λειτουργούν	λειτουργω
λειτούργησε	λειτουργω
λειτουργήματος	λειτουργημα
λεκανοπέδιο	λεκανοπεδιο
λεπτομέρειές	λεπτομερεια
λεπτομέρειες	λεπτομερεια
λεπτομερειών	λεπτομερεια
λεπτομερή	λεπτομερης
λεπτομερείς	λεπτομερης
λεπτομερούς	λεπτομερης
λεπτομερώς	λεπτομερως
λεπτά	λεπτο
λεπτό	λεπτο
λευκή	λευκος
λευκού	λευκος
λευκό	λευκος
λευκός	λευκος
λευκής	λευκος
λευκό	λευκος
λεωφορεία	λεωφορειο
λεωφορείο	λεωφορειο
λεωφορείων	λεωφορειο
λησμονούμε	λησμονω
λιβύης	λιβυη
λιγκ	λιγκ
λιγοστεύουν	λιγοστευω
λιγοστές	λιγοστος
λιγοστούς	λιγοστος
λιθοσκέπαστες	λιθοσκεπαστος
λιμάνι	λιμανι
λιμάνι	λιμανι
λιμένα	λιμενας
λιμενικού	λιμενικος
λιμνούλες	λιμνουλα
λιοντάρι	λιονταρι
λιοτρίβια	λιοτριβι
λιου	λιου
λισαβόνας	λισαβονα
λιτότητας	λιτοτητα
λογαριασμού	λογαριασμος
λογαριασμό	λογαριασμος
λογαριασμός	λογαριασμος
λογαριασμών	λογαριασμος
λογικό	λογικος
λογιστικής	λογιστικη
λογιστική	λογιστικος
λοιπόν	λοιπον
λοιπόν	λοιπον
λοιπά	λοιπος
λοιπές	λοιπος
λοιπών	λοιπος
λουιζιάνα	λουιζιανα
λουκάς	λουκας
λουλουδιασμένες	λουλουδιασμενος
λουλούδια	λουλουδι
λουτρά	λουτρο
λουτρό	λουτρο
λυγίσει	λυγιζω
λυπηρό	λυπηρος
λυπάμαι	λυπουμαι
λυπάμαι	λυπουμαι
λόγιος	λογιος
λόγια	λογος
λόγο	λογος
λόγοι	λογος
λόγος	λογος
λόγου	λογος
λόγους	λογος
λόγω	λογος
λόγω	λογω
λόμπι	λομπι
λόφου	λοφος
λόφους	λοφος
λόχος	λοχος
λύκοι	λυκος
λυθούν	λυνω
λύνει	λυνω
λύσει	λυνω
λύσουμε	λυνω
λύσεις	λυση
λύση	λυση
λύτρωσης	λυτρωση
μάαστριχτ	μααστριχτ
μάθησης	μαθηση
μάιο	μαιος
μαΐου	μαιος
μάλι	μαλι
μάλικι	μαλικι
μάλιστα	μαλιστα
μάλιστα	μαλιστα
μάλλον	μαλλον
μάλλον	μαλλον
μάντσεστερ	μαντσεστερ
μάξι	μαξι
μάρκες	μαρκα
μάρκα	μαρκο
μάρκος	μαρκος
μάρκου	μαρκος
μαρμάρου	μαρμαρο
μαρμάρου	μαρμαρο
μαρμάρων	μαρμαρο
μάρτιο	μαρτιος
μάρτιου	μαρτιος
μαρτίου	μαρτιος
μάρτυρες	μαρτυρας
μάτας	ματας
μάτι	ματι
μάτια	ματι
μάχες	μαχη
μάχη	μαχη
μάχης	μαχη
μέγαρο	μεγαρο
μέγεθος	μεγεθος
μέθοδοι	μεθοδος
μέθοδος	μεθοδος
μεθόδων	μεθοδος
μέλημά	μελημα
μελήματα	μελημα
μέλλον	μελλον
μέλη	μελος
μέλη	μελος
μέλος	μελος
μέλους	μελος
μελών	μελος
μένουμε	μενω
έμειναν	μενω
έμεινε	μενω
μένει	μενω
μένουν	μενω
μείνει	μενω
μείνουν	μενω
μέρα	μερα
μέρες	μερα
μέρει	μερει
μέρη	μερος
μέρος	μερος
μέρους	μερος
μερών	μερος
μέσα	μεσα
μέσα	μεσα
μέσα	μεσο
μέσα	μεσο
μέσο	μεσο
μέσου	μεσο
μέσω	μεσο
μέσων	μεσο
μέση	μεσος
μέσης	μεσος
μέσα	μεσος
μέσο	μεσος
μέσο	μεσος
μέσος	μεσος
μέτρα	μετρο
μέτρο	μετρο
μέτρου	μετρο
μέτρων	μετρο
μέτωπο	μετωπο
μετώπου	μετωπο
μέτωπο	μετωπο
μετώπου	μετωπο
μήκος	μηκος
μήκους	μηκος
μήνα	μηνας
μήνες	μηνας
μηνός	μηνας
μηνών	μηνας
μήνυμά	μηνυμα
μήνυμα	μηνυμα
μηνυμάτων	μηνυμα
μηνύματα	μηνυμα
μήπως	μηπως
μήπως	μηπως
μίλια	μιλι
μίσος	μισος
μαγεία	μαγεια
μαγευτική	μαγευτικος
μαγευτικό	μαγευτικος
μαγεύει	μαγευω
μαγεύουν	μαγευω
μαζί	μαζι
μαζί	μαζι
μαζέψουμε	μαζευω
μαζική	μαζικος
μαζικών	μαζικος
μάθουμε	μαθαινω
μαθησιακούς	μαθησιακος
μαθητές	μαθητης
μαθητή	μαθητης
μαθητής	μαθητης
μαθητών	μαθητης
μακάβριες	μακαβριος
μακεδονίας	μακαεδονια
μακεδονία	μακεδονια
μακεδονίας	μακεδονια
μακεδονικό	μακεδονικος
μακεδονική	μακεδονικος
μακεδονικής	μακεδονικος
μακεδονικού	μακεδονικος
μακεδόνες	μακεδονας
μακελειό	μακελειο
μακριά	μακρια
μακροπρόθεσμες	μακροπροθεσμος
μακροπρόθεσμη	μακροπροθεσμος
μακρόχρονη	μακροχρονιος
μακροβιότερος	μακροβιος
μακρόπνοοι	μακροπνοος
μακρά	μακρυς
μακράς	μακρυς
μακρών	μακρυς
μαλακανάνγκ	μαλακανανγκ
μαμές	μαμες
μανουέλ	μανουελ
μαρία	μαρια
μαρίνα	μαρινα
μαραθώνιων	μαραθωνιος
μαργαρίτης	μαργαριτης
μαριάνες	μαριανες
μαρξιστής	μαρξιστης
μαρτυρείται	μαρτυρω
μαρτυρούν	μαρτυρω
μαστίζει	μαστιζω
μαστιλίτσας	μαστιλιτσα
ματιά	ματια
ματιά	ματια
μαυριτανών	μαυριτανος
μαυροβούνιος	μαυροβουνιος
μαυρονόρος	μαυρονορος
μαφιόζων	μαφιοζος
μαχητών	μαχητος
μαχμούντ	μαχμουντ
μαύρον	μαυρος
μαύρος	μαυρος
μείωση	μειωση
μεγάλες	μεγαλος
μεγάλη	μεγαλος
μεγάλης	μεγαλος
μεγάλο	μεγαλος
μεγάλων	μεγαλος
μέγιστη	μεγαλος
μέγιστη	μεγαλος
μέγιστης	μεγαλος
μείζονα	μεγαλος
μείζονες	μεγαλος
μεγάλα	μεγαλος
μεγάλες	μεγαλος
μεγάλη	μεγαλος
μεγάλης	μεγαλος
μεγάλο	μεγαλος
μεγάλος	μεγαλος
μεγάλου	μεγαλος
μεγάλους	μεγαλος
μεγάλων	μεγαλος
μεγαλύτερες	μεγαλος
μεγαλύτερη	μεγαλος
μεγαλύτερης	μεγαλος
μεγαλύτερο	μεγαλος
μεγαλομέτοχος	μεγαλομετοχος
μεγιστοποίηση	μεγιστοποιηση
μεγιστοποιήσουμε	μεγιστοποιω
μεθαύριο	μεθαυριο
μεθεπομένη	μεθεπομενος
μεθοδολογία	μεθοδολογια
μεθοδολογιών	μεθοδολογια
μεθόδευση	μεθοδευση
μειονεκτήματα	μειονεκτημα
μειονεκτική	μειονεκτικος
μειονότητα	μειονοτητα
μειονότητας	μειονοτητα
μειονότητες	μειονοτητα
μειοψηφία	μειοψηφια
μειοψηφίας	μειοψηφια
μείωσε	μειωνω
μειωθούν	μειωνω
μειωμένες	μειωνω
μειώθηκαν	μειωνω
μειώνει	μειωνω
μειώσουμε	μειωνω
μελέτης	μελετη
μελέτη	μελετη
μελέτης	μελετη
μελετήσει	μελετω
μελετώντας	μελετω
μελιού	μελιος
μελλοντικά	μελλοντικα
μελλοντικές	μελλοντικος
μελλοντική	μελλοντικος
μελλοντικού	μελλοντικος
μελλοντικών	μελλοντικος
μεμονωμένη	μεμονωμενος
μεμονωμένων	μεμονωμενος
μεν	μεν
μεντβέντεφ	μεντβεντεφ
μεξικού	μεξικο
μεράχ	μεραχ
μερικών	μερικοι
μερικής	μερικος
μερικώς	μερικως
μεριμνούμε	μεριμνω
μερκάλι	μερκαλι
μεσάζοντας	μεσαζοντας
μεσαία	μεσαιος
μεσαιωνική	μεσαιωνικος
μεσαιωνικής	μεσαιωνικος
μεσαιωνικό	μεσαιωνικος
μεσαιωνικών	μεσαιωνικος
μεσημέρι	μεσημερι
μεσογειακή	μεσογειακος
μεσολάβησή	μεσολαβηση
μεσολαβητικούς	μεσολαβητικος
μετά	μετα
μετά	μετα
μετάβαση	μεταβαση
μετάβασης	μεταβαση
μετείχε	μετεχω
μετα	μετα
μεταβάλει	μεταβαλλω
μεταβληθεί	μεταβαλλω
μεταβίβαση	μεταβιβαση
μετέβη	μεταβαινω
μεταβαίνουν	μεταβαινω
μεταβεί	μεταβαινω
μεταβατική	μεταβατικος
μεταβιβάσω	μεταβιβαζω
μεταβιβαστούν	μεταβιβαζω
μετέδιδαν	μεταδιδω
μετέδωσαν	μεταδιδω
μετέδωσε	μεταδιδω
μεταδίδουν	μεταδιδω
μετακίνηση	μετακινηση
μετακίνησης	μετακινηση
μετακινήσεων	μετακινηση
μετακινήσει	μετακινω
μετακινηθήκαμε	μετακινω
μετακινηθούν	μετακινω
μεταλίστ	μεταλιστ
μεταλλείων	μεταλλειο
μεταλλείων	μεταλλειο
μετανάστευσης	μεταναστευση
μετανάστευσης	μεταναστευση
μετανάστες	μεταναστης
μεταναστευτικό	μεταναστευτικος
μεταξύ	μεταξυ
μεταπολεμικές	μεταπολεμικος
μεταπολεμική	μεταπολεμικος
μεταρρυθμιστική	μεταρρυθμιστικος
μεταρρυθμιστική	μεταρρυθμιστικος
μεταρρυθμιστικής	μεταρρυθμιστικος
μεταρρυθμιστικό	μεταρρυθμιστικος
μεταρρυθμίσεις	μεταρρυθμιση
μεταρρυθμίσεων	μεταρρυθμιση
μεταρρυθμίσεών	μεταρρυθμιση
μεταρρύθμιση	μεταρρυθμιση
μεταστροφή	μεταστροφη
μετέτρεψαν	μετατρεπω
μετατράπηκε	μετατρεπω
μετατρέπεται	μετατρεπω
μετατραπούν	μετατρεπω
μετέφερε	μεταφερω
μεταφέρθηκαν	μεταφερω
μεταφέρθηκε	μεταφερω
μεταφέρονται	μεταφερω
μεταφέρουμε	μεταφερω
μεταφερθεί	μεταφερω
μεταφορών	μεταφορα
μεταφορά	μεταφορα
μεταφοράς	μεταφορα
μεταφορές	μεταφορα
μεταφορές	μεταφορα
μεταφορών	μεταφορα
μεταφορέων	μεταφορεας
μεταφορείς	μεταφορεας
μεταχείριση	μεταχειριση
μεταχείρισης	μεταχειριση
μετεγκαταστάσεις	μετεγκατασταση
μετεκπαίδευσή	μετεκπαιδευση
μετεπιβιβάσεων	μετεπιβιβαση
μετεωρολογική	μετεωρολογικος
μετονομάζει	μετονομαζω
μετρήσιμες	μετρησιμος
μετριασμένη	μετριαζω
μετριοπαθείς	μετριοπαθης
μέτρησαν	μετρω
μετρά	μετρω
μετρήθηκε	μετρω
μητέρα	μητερα
μητρόπολη	μητροπολη
μηχανήματα	μηχανημα
μηχανή	μηχανη
μηχανισμούς	μηχανισμος
μηχανοκίνητες	μηχανοκινητος
μιζουράτα	μιζουρατα
μικρασιατικής	μικρασιατικος
μικρή	μικρος
μικρά	μικρος
μικρές	μικρος
μικρή	μικρος
μικροί	μικρος
μικρό	μικρος
μικρότερα	μικρος
μικρότερες	μικρος
μικρότερου	μικρος
μιλήστε	μιλω
μιλώντας	μιλω
μίλησαν	μιλω
μιλάει	μιλω
μιλάμε	μιλω
μιλήσατε	μιλω
μιλήσουμε	μιλω
μιλήσουν	μιλω
μιλούν	μιλω
μιναρέ	μιναρες
μινσκ	μινσκ
μισθούς	μισθος
μισθούς	μισθος
μισθών	μισθος
μισουράτα	μισουρατα
μισοχαλασμένο	μισοχαλασμενο
μισά	μισο
μισή	μισος
μισοί	μισος
μισό	μισος
μιτ	μιτ
μμε	μμε
μνημεία	μνημειο
μνημείο	μνημειο
μνημείων	μνημειο
μοίρας	μοιρα
μοιάζει	μοιαζω
μοιραστεί	μοιραζω
μονάδας	μοναδα
μονάδες	μοναδα
μονάρχης	μοναρχης
μονάχα	μοναχα
μονή	μονη
μονής	μονη
μοναδική	μοναδικος
μοναδικής	μοναδικος
μοναδικό	μοναδικος
μοναδικότητα	μοναδικοτητα
μοναρχία	μοναρχια
μοναστήρι	μοναστηρι
μοναστήρι	μοναστηρι
μοναστήρι	μοναστηρι
μοναστήρια	μοναστηρι
μοναστηριακού	μοναστηριακος
μοναχοί	μοναχος
μονομερώς	μονομερως
μονοπάτι	μονοπατι
μονοπάτια	μονοπατι
μονοπωλίων	μονοπωλιο
μονότοξα	μονοτοξος
μορφή	μορφη
μορφής	μορφη
μορφολογία	μορφολογια
μουμπάρακ	μουμπαρακ
μουν	μουν
μουνιάιν	μουνιαιν
μουσάραφ	μουσαραφ
μουσείο	μουσειο
μουσεία	μουσειο
μουσείο	μουσειο
μουσουλμάνοι	μουσουλμανος
μουσουλμανική	μουσουλμανικος
μουσουλμανικό	μουσουλμανικος
μοχάμεντ	μοχαμεντ
μοχάμουντ	μοχαμουντ
μούρτος	μουρτος
μπάιντεν	μπαιντεν
μπάλα	μπαλα
μπάλας	μπαλα
μπάμπα	μπαμπα
μπέιζμπωλ	μπειζμπωλ
μπήκε	μπαινω
μπαίνει	μπαινω
μπαίνουν	μπαινω
μπαν	μπαν
μπανάνα	μπανανα
μπαρ	μπαρ
μπαράκ	μπαρακ
μπαρόζο	μπαροζο
μπατίστα	μπατιστα
μπαχτσισαράι	μπαχτσισαραι
μπενίνιο	μπενινιο
μπενφίκα	μπενφικα
μπιλ	μπιλ
μπιλμπάο	μπιλμπαο
μπιν	μπιν
μπλέκει	μπλεκω
μπλακ	μπλακ
μπλας	μπλας
μπλε	μπλε
μπολσεβίκων	μπολσεβικα
μπολσεβικισμό	μπολσεβικισμος
μπορεί	μπορω
μπορούμε	μπορω
μπορέσει	μπορω
μπορέσετε	μπορω
μπορέσουμε	μπορω
μπορέσουν	μπορω
μπορεί	μπορω
μπορείτε	μπορω
μπορούμε	μπορω
μπορούν	μπορω
μπορούσαμε	μπορω
μπορούσαν	μπορω
μπορούσε	μπορω
μπορώ	μπορω
μπόρεσαν	μπορω
μπόρεσε	μπορω
μποϊκοτάρει	μποικοταρω
μπροζ	μπροζ
μπροστά	μπροστα
μπόζα	μποζα
μυθολογία	μυθολογια
μυλωνάς	μυλωνας
μύριζε	μυριζω
μυστήριο	μυστηριο
μυστήρια	μυστηριος
μυστηρίου	μυστηριος
μυστικών	μυστικος
μόλις	μολις
μόνιμη	μονιμος
μόνιμο	μονιμος
μόνο	μονο
μόνο	μονο
μόνον	μονο
μόνη	μονος
μόνο	μονος
μόνο	μονος
μόνοι	μονος
μόρφωση	μορφωση
μόσχας	μοσχα
μύθος	μυθος
μώλος	μωλος
νippon	νippon
νέα	νεος
νέας	νεος
νέο	νεος
νέου	νεος
νεώτερης	νεος
νέα	νεος
νέας	νεος
νέες	νεος
νέο	νεος
νέοι	νεος
νέοι	νεος
νέος	νεος
νέου	νεος
νέους	νεος
νέους	νεος
νέων	νεος
νέων	νεος
νεότατης	νεος
νεότερα	νεος
νεότερο	νεος
νέστο	νεστος
νέων	νεων
νήσος	νησος
νήσων	νησος
νίκη	νικη
νίκες	νικη
νίκη	νικη
ναβάλνι	ναβαλνι
ναζιστικά	ναζιστικος
ναι	ναι
ναπολέοντα	ναπολεοντας
ναπολέων	ναπολεων
ναρκωτικά	ναρκωτικος
ναρκωτικά	ναρκωτικος
ναρκωτικών	ναρκωτικος
ναρκωτικών	ναρκωτικος
ναυλοχούσαν	ναυλοχω
ναυμαχία	ναυμαχια
ναυτικά	ναυτικος
ναυτικής	ναυτικος
ναυτοπροσκόπων	ναυτοπροσκοπος
ναό	ναος
ναυάρχους	ναυαρχος
ναυάρχων	ναυαρχος
ναύαρχο	ναυαρχος
νγκουγέν	νγκουγεν
νεαρά	νεαρος
νεαρές	νεαρος
νεκρομαντείο	νεκρομαντειο
νεκροταφείο	νεκροταφειο
νεκρόπολης	νεκροπολη
νεκρός	νεκρος
νεκροί	νεκρος
νεκρούς	νεκρος
νεκρούς	νεκρος
νεκρών	νεκρος
νεογνά	νεογνο
νεολαία	νεολαια
νεολαία	νεολαια
νεολαίας	νεολαια
νεολαια	νεολαια
νεοναζί	νεοναζι
νεοναζιστικής	νεοναζιστικος
νεοσχηματισθείσα	νεοσχηματισθεισα
νεοσύστατη	νεοσυστατος
νερό	νερο
νερά	νερο
νερού	νερο
νερό	νερο
νερό	νερο
νερόλακκοι	νερολακκος
νερόμυλοι	νερομυλος
νετανιάχου	νετανιαχου
νετανιάχου	νετανιαχου
νευροκοπίου	νευροκοπι
νευροκόπι	νευροκοπι
νευρολογικής	νευρολογικος
νευρώνων	νευρωνας
νεϊγύ	νειγυ
νεόπτωχων	νεοπτωχος
νησάκι	νησακι
νησάκια	νησακι
νησί	νησι
νησί	νησι
νησιά	νησι
νησιού	νησι
νησιών	νησι
νησίδα	νησιδα
νικητριών	νικητρια
νικητήριες	νικητηριος
νικητής	νικητης
νικηφόρα	νικηφορος
νικολά	νικολα
νικοτσάρα	νικοτσαρας
νικολάου	νικολαος
νικόλαο	νικολαος
νικόλαος	νικολαος
νίκησαν	νικω
νίκησαν	νικω
νίκησε	νικω
νικά	νικω
νικήθηκε	νικω
νιουτ	νιουτ
νιούτ	νιουτ
νιραγκόνγκο	νιραγκονγκο
ένιωθε	νιωθω
νοέμβριο	νοεμβριος
νοέμβριο	νοεμβριος
νοεμβρίου	νοεμβριος
νομίζω	νομιζω
νομίζει	νομιζω
νομίζω	νομιζω
νομικά	νομικα
νομικών	νομικος
νομικά	νομικος
νομικές	νομικος
νομική	νομικος
νομικής	νομικος
νομικό	νομικος
νομιμοποιητική	νομιμοποιητικος
νομιμοποιημένης	νομιμοποιω
νομιμότητας	νομιμοτητα
νομισματική	νομισματικος
νομισματικής	νομισματικος
νομισματική	νομισματικος
νομοθετών	νομοθετης
νομοθεσία	νομοθεσια
νομοθεσίας	νομοθεσια
νομοθεσιών	νομοθεσια
νομοθετικά	νομοθετικος
νομοθετικές	νομοθετικος
νομοθετική	νομοθετικος
νομοθετικής	νομοθετικος
νομοθετικό	νομοθετικος
νομοθετικών	νομοθετικος
νομολογία	νομολογια
νομοσχέδιο	νομοσχεδιο
νομού	νομος
νομό	νομος
νορβηγοί	νορβηγος
νοσηλεύονται	νοσηλευω
νοσοκομείο	νοσοκομειο
νοσοκομεία	νοσοκομειο
νοσοκομείο	νοσοκομειο
νοτιοανατολικές	νοτιοανατολικος
νοτιοανατολική	νοτιοανατολικος
νοτιοδυτικά	νοτιοδυτικα
νους	νους
ντάμπιγκ	νταμπιγκ
ντέμιαντσουκ	ντεμιαντσουκ
νταβίδ	νταβιδ
νταχού	νταχου
ντε	ντε
ντελφίν	ντελφιν
ντιαογιού	ντιαογιου
ντικιλί	ντικιλι
ντμίτρι	ντμιτρι
ντρέπεται	ντρεπομαι
ντριαν	ντριαν
ντόπια	ντοπιος
ντόπιους	ντοπιος
νωρίτερα	νωρις
νωρίτερα	νωρις
νόημα	νοημα
νομίμως	νομιμα
νόμιμης	νομιμος
νόμιμου	νομιμος
νομίσματα	νομισμα
νομίσματος	νομισμα
νόμισμά	νομισμα
νόμισμα	νομισμα
νόμο	νομος
νόμος	νομος
νόμου	νομος
νόμων	νομος
νόσου	νοσος
νοτιότερα	νοτια
νότια	νοτια
νότιοδυτικό	νοτιοδυτικο
νοτίου	νοτιος
νότια	νοτιος
νότιας	νοτιος
νότιο	νοτιος
νότιος	νοτιος
νοτίων	νοτιος
νότια	νοτιος
νότια	νοτιος
νότιας	νοτιος
νότιες	νοτιος
νότιο	νοτιος
νότο	νοτος
νύμφη	νυμφη
νύμφωνας	νυμφωνας
νύχτα	νυχτα
νύχτας	νυχτα
ξένες	ξενος
ξένο	ξενος
ξένους	ξενος
ξένων	ξενος
ξέρω	ξερω
ξέρει	ξερω
ξέσπασμα	ξεσπασμα
ξέσπασμα	ξεσπασμα
ξανά	ξανα
ξαναβάλει	ξαναβαζω
ξαναγράψει	ξαναγραφω
ξαναζητήσει	ξαναζητω
ξανακτίσουν	ξανακτιζω
ξαναρχίζει	ξαναρχιζω
ξανασυναντηθούν	ξανασυναντω
ξανασυνεδριάσει	ξανασυνεδριαζω
ξαντάο	ξανταο
ξεκάθαρα	ξεκαθαρα
ξεκάθαρες	ξεκαθαρος
ξεκίνημα	ξεκινημα
ξεκαθαρίζοντας	ξεκαθαριζω
ξεκίνησαν	ξεκινω
ξεκίνησε	ξεκινω
ξεκινάει	ξεκινω
ξεκινάμε	ξεκινω
ξεκινήσει	ξεκινω
ξεκινήσουμε	ξεκινω
ξεκινήσουν	ξεκινω
ξεκινήσω	ξεκινω
ξεκινούν	ξεκινω
ξενάγηση	ξεναγηση
ξεναγούνται	ξεναγω
ξενοδοχείων	ξενοδοχειο
ξενώνων	ξενωνας
ξεπέρασαν	ξεπερνω
ξεπεράσουμε	ξεπερνω
ξεπερνούν	ξεπερνω
ξεπερνώντας	ξεπερνω
ξεσηκωμό	ξεσηκωμος
ξεσηκώθηκαν	ξεσηκωνω
ξέσπασαν	ξεσπω
ξέσπασε	ξεσπω
ξεχασμένο	ξεχνω
ξεχνάμε	ξεχνω
ξεχωρίζει	ξεχωριζω
ξημερώματα	ξημερωμα
ξηρά	ξηρα
ξύλινη	ξυλενιος
ξύλινο	ξυλενιος
ξυλοκοπούν	ξυλοκοπω
ξυλόγλυπτο	ξυλογλυπτος
ξύλο	ξυλο
ξύλου	ξυλο
οίκο	οικος
οίκος	οικος
οίκου	οικος
οίκο	οικος
οασε	οασε
οβίδες	οβιδα
οδήγηση	οδηγηση
οδήγησης	οδηγηση
οδεύει	οδευω
οδηγία	οδηγια
οδηγίας	οδηγια
οδηγίες	οδηγια
οδηγιών	οδηγια
οδηγοί	οδηγος
οδηγού	οδηγος
οδηγούς	οδηγος
οδηγός	οδηγος
οδηγών	οδηγος
οδήγησαν	οδηγω
οδήγησε	οδηγω
οδηγήσει	οδηγω
οδηγήσουν	οδηγω
οδηγεί	οδηγω
οδηγούν	οδηγω
οδηγώντας	οδηγω
οδικές	οδικος
οδική	οδικος
οδικής	οδικος
οδικό	οδικος
οδικών	οδικος
οδικώς	οδικως
οδυνηρές	οδυνηρος
οδυνηρή	οδυνηρος
οδού	οδος
οδού	οδος
οδούς	οδος
οδό	οδος
οδόν	οδος
οθωμανική	οθωμανικος
οθωμανικό	οθωμανικος
οθωμανικού	οθωμανικος
οθωμανούς	οθωμανος
οικισμοί	οικισμος
οικισμού	οικισμος
οικισμούς	οικισμος
οικισμό	οικισμος
οικισμός	οικισμος
οικογένειά	οικογενεια
οικογένεια	οικογενεια
οικογένειας	οικογενεια
οικογένειες	οικογενεια
οικογενείας	οικογενεια
οικογενειών	οικογενεια
οικοδεσπότες	οικοδεσποτης
οικοδομών	οικοδομη
οικοδόμηση	οικοδομηση
οικολογικού	οικολογικος
οικολογικών	οικολογικος
οικονομία	οικονομια
οικονομίας	οικονομια
οικονομιών	οικονομια
οικονομικών	οικονομικα
οικονομικά	οικονομικα
οικονομική	οικονομικος
οικονομικής	οικονομικος
οικονομικά	οικονομικος
οικονομικές	οικονομικος
οικονομική	οικονομικος
οικονομικής	οικονομικος
οικονομικού	οικονομικος
οικονομικούς	οικονομικος
οικονομικό	οικονομικος
οικονομικών	οικονομικος
οκλαχόμα	οκλαχομα
οκτάγωνο	οκταγωνος
οκτώβριο	οκτωβριο
οκτωβρίου	οκτωβριος
ολίγου	ολιγος
ολίγου	ολιγος
ολιβέιρα	ολιβειρα
ολλανδίας	ολλανδια
ολλανδοί	ολλανδος
ολλανδών	ολλανδος
ολοένα	ολοενα
ολοκλήρωση	ολοκληρωση
ολοκληρωθεί	ολοκληρωνω
ολοκληρωθούν	ολοκληρωνω
ολοκληρωμένη	ολοκληρωνω
ολοκληρώθηκε	ολοκληρωνω
ολοκληρώνονται	ολοκληρωνω
ολοκληρώσαμε	ολοκληρωνω
ολοκληρώσει	ολοκληρωνω
ολοκληρώσουμε	ολοκληρωνω
ολοκληρώσω	ολοκληρωνω
ολομέλεια	ολομελεια
ολομέλεια	ολομελεια
ολομέλειας	ολομελεια
ολομέλειες	ολομελεια
ολονύκτιες	ολονυκτιος
ολοσχερώς	ολοσχερως
ολυμπιακή	ολυμπιακος
ολυμπιακό	ολυμπιακος
ολόκληρες	ολοκληρος
ολόκληρη	ολοκληρος
ολόκληρης	ολοκληρος
ολόκληρο	ολοκληρος
ολόκληρου	ολοκληρος
ολότητά	ολοτητα
ομάδα	ομαδα
ομάδας	ομαδα
ομάδες	ομαδα
ομάδα	ομαδα
ομάδας	ομαδα
ομάδες	ομαδα
ομάδων	ομαδα
ομαδικά	ομαδικα
ομαλοποιηθεί	ομαλοποιω
ομαλή	ομαλος
ομηρία	ομηρια
ομιλία	ομιλια
ομιλίες	ομιλια
ομιλιών	ομιλια
ομιλητές	ομιλητης
ομοιότητες	ομοιοτητα
ομολογήσουμε	ομολογω
ομορφιά	ομορφια
ομορφιάς	ομορφια
ομοσπονδία	ομοσπονδια
ομοσπονδίας	ομοσπονδια
ομοσπονδίας	ομοσπονδια
ομοσπονδιακή	ομοσπονδιακος
ομοσπονδιακής	ομοσπονδιακος
ομοσπονδιακά	ομοσπονδιακος
ομοσπονδιακό	ομοσπονδιακος
ομπάμα	ομπαμα
ομφαλοσκόπηση	ομφαλοσκοπηση
ομφαλοσκόπησης	ομφαλοσκοπηση
ομόλογό	ομολογο
ομολόγους	ομολογος
ομόσπονδες	ομοσπονδος
ομόφωνα	ομοφωνα
ομόφωνη	ομοφωνος
ομόφωνο	ομοφωνος
ονα	ονα
ονομάζεται	ονομαζω
ονομάστηκε	ονομαζω
ονομαζόταν	ονομαζω
ονομασία	ονομασια
οξιές	οξια
οπαδοί	οπαδος
οπαδούς	οπαδος
οπαδών	οπαδος
οπισθοδρόμηση	οπισθοδρομηση
οπλα	οπλα
οπλαρχηγοί	οπλαρχηγος
οπλισμένο	οπλισμενος
οπλισμό	οπλισμος
οπλοστασίου	οπλοστασιο
οπουδήποτε	οπουδηποτε
οπτική	οπτικος
οπωσδήποτε	οπωσδηποτε
ορίζοντα	οριζοντας
ορίζει	οριζω
ορίζουμε	οριζω
ορίσαμε	οριζω
ορίσουμε	οριζω
οριστεί	οριζω
ορατά	ορατος
ορατή	ορατος
οργάνωση	οργανωση
οργάνωσης	οργανωση
οργάνωση	οργανωση
οργάνωσης	οργανωση
οργανώσεις	οργανωση
οργανώσεων	οργανωση
οργανισμό	οργανισμος
οργανισμοί	οργανισμος
οργανισμού	οργανισμος
οργανισμούς	οργανισμος
οργανισμό	οργανισμος
οργανισμών	οργανισμος
οργανωμένες	οργανωνω
οργανωμένη	οργανωνω
οργανώθηκε	οργανωνω
οργανώνουν	οργανωνω
οργανώσει	οργανωνω
οργανώσουμε	οργανωνω
ορειβασία	ορειβασια
ορειβατικό	ορειβατικος
ορεινή	ορεινος
ορεινά	ορεινος
ορεινή	ορεινος
ορεινούς	ορεινος
ορθώς	ορθα
ορθών	ορθο
ορθόδοξη	ορθοδοξος
ορθή	ορθος
ορθής	ορθος
οριζόντιο	οριζοντιος
οριοθέτηση	οριοθετηση
ορισμένοι	ορισμενος
ορισμένα	ορισμενος
ορισμένες	ορισμενος
ορισμένο	ορισμενος
ορισμένοι	ορισμενος
ορισμένους	ορισμενος
ορισμένων	ορισμενος
ορισμούς	ορισμος
ορισμό	ορισμος
ορισμός	ορισμος
ορισμών	ορισμος
οριστικά	οριστικα
οριστικοποιήθηκε	οριστικοποιω
οριστική	οριστικος
ορκίστηκε	ορκιζω
ορόσημο	οροσημο
οσάμα	οσαμα
οσάμου	οσαμου
οσετίας	οσετια
οσμή	οσμη
ουδεμία	ουδεις
ουζερί	ουζερι
ουκρανία	ουκρανια
ουκρανοί	ουκρανος
ουκρανούς	ουκρανος
ουλντ	ουλντ
ουμάρ	ουμαρ
ουνταλτσόφ	ουνταλτσοφ
ουρανοφόρα	ουρανοφορα
ουρανό	ουρανος
ουσία	ουσια
ουσίας	ουσια
ουσίες	ουσια
ουσιών	ουσια
ουσιαστικά	ουσιαστικα
ουσιαστικά	ουσιαστικα
ουσιαστικοποιημένο	ουσιαστικοποιω
ουσιαστική	ουσιαστικος
ουσιαστικής	ουσιαστικος
ουσιαστικό	ουσιαστικος
ουσιώδες	ουσιωδης
ουσιώδης	ουσιωδης
οφείλουμε	οφειλω
οφείλω	οφειλω
οφείλει	οφειλω
οφείλεται	οφειλω
οφείλονται	οφειλω
οφείλουμε	οφειλω
οφείλουν	οφειλω
οφείλω	οφειλω
οχάιο	οχαιο
οχρίδα	οχριδα
οχυρωθούν	οχυρωνω
οχυρώνει	οχυρωνω
οχύρωσαν	οχυρωνω
ούντερλιν	ουντερλιν
ούτως	ουτως
παθήσεις	παθηση
πάλι	παλι
πάντα	παν
πάντα	παντα
πάντοτε	παντοτε
πάντως	παντως
πάντως	παντως
πάνω	πανω
πάνω	πανω
πάπας	παπας
πάπιες	παπια
πάρα	παρα
πάραυτα	παραυτα
πάρεργο	παρεργος
πάρκο	παρκο
πάρκο	παρκο
πασχόντων	πασχων
πατωμάτων	πατωμα
πέλαγος	πελαγος
πέλαγος	πελαγος
πέμπτη	πεμπτη
πέμπτον	πεμπτος
πέναλτι	πεναλτι
πέναλτι	πεναλτι
πένθους	πενθος
πέρα	περα
πέραμο	περαμος
πέραν	περαν
πέρας	περας
πέρασμα	περασμα
πέρσες	περσης
πέρσι	περσι
πέρσι	περυσι
πέρυσι	περυσι
πέρσι	περυσι
πέρυσι	περυσι
πέταλο	πεταλο
πέτρες	πετρα
πέτρινα	πετρινος
πέτροβιτς	πετροβιτς
έπεσε	πεφτω
πέσουν	πεφτω
πίεση	πιεση
πίεσης	πιεση
πίζας	πιζα
πιθήκους	πιθηκος
πίσω	πισω
πίτσες	πιτσα
έπαιξε	παιζω
παίξει	παιζω
παίξουν	παιζω
παίκτες	παικτης
έπαιρνε	παιρνω
πάρει	παιρνω
πάρουν	παιρνω
πήρε	παιρνω
πήρε	παιρνω
παίρνει	παιρνω
παίρνουν	παιρνω
παγγαίο	παγγαιο
παγγαίου	παγγαιο
παγγαίου	παγγαιο
παγγαίου	παγγαιο
παγιδευμένα	παγιδευμενος
παγιδευμένου	παγιδευμενος
παγιωμένο	παγιωνω
παγκοσμίως	παγκοσμια
παγκοσμίου	παγκοσμιος
παγκόσμια	παγκοσμιος
παγκόσμιας	παγκοσμιος
παγκόσμιο	παγκοσμιος
παγκόσμιος	παγκοσμιος
παγκόσμια	παγκοσμιος
παγκόσμιο	παγκοσμιος
παγώσει	παγωνω
έπαθαν	παθαινω
παθητική	παθητικος
παιδιά	παιδι
παιδιών	παιδι
παιδεία	παιδεια
παιχνίδι	παιχνιδι
παιχνιδιού	παιχνιδι
παιόνια	παιονια
πακιστάν	πακισταν
πακιστανική	πακιστανικος
πακιστανικών	πακιστανικος
παλάτι	παλατι
παλάτι	παλατι
παλαίστρα	παλαιστρα
παλαιοιλιθική	παλαιοιλιθικη
παλαιοχριστιανικές	παλαιοχριστιανικος
παλαιοχωρίου	παλαιοχωρι
παλαιστίνιο	παλαιστινιος
παλαιστίνιους	παλαιστινιος
παλαιστινιακή	παλαιστινιακος
παλαιστινιακού	παλαιστινιακος
παλαιά	παλαιος
παλεύει	παλευω
παλιότερα	παλια
παλαιότερα	παλια
παλιοχριστιανική	παλιοχριστιανικη
παλιοχριστιανικές	παλιοχριστιανικος
παλαιό	παλιος
παλιό	παλιος
παλαιές	παλιος
παλιά	παλιος
παλιούς	παλιος
παλιό	παλιος
πανάρχαιες	παναρχαιος
πανέμορφα	πανεμορφος
πανέμορφες	πανεμορφος
πανέμορφες	πανεμορφος
πανέτα	πανετα
πανίδα	πανιδα
πανίδας	πανιδα
παναγία	παναγια
παναγίας	παναγια
παναγιά	παναγια
παναγιάς	παναγια
πανεπιστήμια	πανεπιστημιο
πανεπιστημίου	πανεπιστημιο
πανεπιστημιακών	πανεπιστημιακος
πανευρωπαϊκή	πανευρωπαικος
πανευρωπαϊκό	πανευρωπαικος
πανικό	πανικος
πανοραμική	πανοραμικος
παντελή	παντελης
παντού	παντου
πανύψηλα	πανυψηλος
παπαβλαχάβα	παπαβλαχαβας
παπανδρέου	παπανδρεου
παπανδρέου	παπανδρεου
παπουτσιών	παπουτσι
παπούτσια	παπουτσι
παππούς	παππους
παράβαση	παραβαση
παράγοντες	παραγοντας
παράγων	παραγοντας
παράγονται	παραγω
παράδειγμα	παραδειγμα
παραδείγματα	παραδειγμα
παραδειγμάτων	παραδειγμα
παράδοξη	παραδοξος
παράδοση	παραδοση
παράδοσης	παραδοση
παράκτια	παρακτιος
παράλειψη	παραλειψη
παράλληλα	παραλληλα
παράλληλα	παραλληλα
παράλληλες	παραλληλος
παράλληλους	παραλληλος
παράλογος	παραλογος
παράμετροι	παραμετρος
παρανόμως	παρανομα
παράνομες	παρανομος
παράνομη	παρανομος
παράνομης	παρανομος
παράνομοι	παρανομος
παράπονα	παραπονο
παραπόνων	παραπονο
παράρτημα	παραρτημα
παραστάσεις	παρασταση
παράταση	παραταση
παρέλευση	παρελευση
παρεμβάσεις	παρεμβαση
παράσχουν	παρεχω
παρέχει	παρεχω
παρέχονται	παρεχω
παρέχουμε	παρεχω
παρέχουν	παρεχω
παρισιού	παρισι
παρέστη	παρισταμαι
παραστούν	παρισταμαι
παραίτησή	παραιτηση
παραίτηση	παραιτηση
παραίτησης	παραιτηση
παραβίαση	παραβιαση
παραβιάσεις	παραβιαση
παραβατικής	παραβατικος
παραβίαζε	παραβιαζω
παραβιάζονται	παραβιαζω
παραβιάζοντας	παραβιαζω
παραβιάζουν	παραβιαζω
παραβλαφθούν	παραβλαπτω
παραγγελθεί	παραγγελλω
παραγγελίες	παραγγελια
παραγκωνίσει	παραγκωνιζω
παραγνωριστούν	παραγνωριζω
παραγραφή	παραγραφη
παραγωγή	παραγωγη
παραγωγής	παραγωγη
παραγωγική	παραγωγικος
παραγωγικότητας	παραγωγικοτητα
παραγωγός	παραγωγος
παραγωγών	παραγωγος
παραδεχθεί	παραδεχομαι
παραδεχτούμε	παραδεχομαι
παρέδωσαν	παραδινω
παρέδωσε	παραδινω
παραδινόταν	παραδινω
παραδόθηκε	παραδινω
παραδώσει	παραδινω
παραδειγματικής	παραδειγματικος
παραδοσιακά	παραδοσιακος
παραδοσιακές	παραδοσιακος
παραδοσιακή	παραδοσιακος
παραδοσιακό	παραδοσιακος
παραθέτω	παραθετω
παραθαλάσσιος	παραθαλασσιος
παραιτήθηκε	παραιτουμαι
παραιτείται	παραιτουμαι
παραιτηθεί	παραιτουμαι
παραιτήθηκε	παραιτω
παραιτηθεί	παραιτω
παρακείμενο	παρακειμενος
παρακινήσει	παρακινω
παρακμής	παρακμη
παρακολουθεί	παρακολουθω
παρακολουθούσαν	παρακολουθω
παρακολούθηση	παρακολουθηση
παρακολούθησης	παρακολουθηση
παρακώλυε	παρακωλυω
παραλία	παραλια
παραλίας	παραλια
παραλίες	παραλια
παραλάβαμε	παραλαβαινω
παραλείψετε	παραλειπω
παραλείψω	παραλειπω
παραλληλισμό	παραλληλισμος
παρέμεναν	παραμενω
παρέμενε	παραμενω
παραμένει	παραμενω
παραμένουν	παραμενω
παραμείνει	παραμενω
παραμείνουν	παραμενω
παραμείνω	παραμενω
παραμελημένα	παραμελω
παραμερισθούν	παραμεριζω
παραμικρή	παραμικρος
παραμυθίας	παραμυθια
παρανομίες	παρανομια
παραπάνω	παραπανω
παραπέμπει	παραπεμπω
παραπέμψει	παραπεμπω
παραπεμφθεί	παραπεμπω
παραπεμφθούν	παραπεμπω
παραπέρα	παραπερα
παραπέτασμα	παραπετασμα
παραπετάσματος	παραπετασμα
παραπλήσια	παραπλησιος
παρασκευαστεί	παρασκευαζω
παρασκευή	παρασκευη
παρασκευή	παρασκευη
παραστρατιωτικές	παραστρατιωτικος
παρατήρηση	παρατηρηση
παρατηρήσεις	παρατηρηση
παρατηρητές	παρατηρητης
παρατηρητής	παρατηρητης
παρατηρητών	παρατηρητης
παρατηρούμενης	παρατηρουμενος
παρατηρώ	παρατηρω
παρατήρησε	παρατηρω
παρατηρήσω	παρατηρω
παρατηρείται	παρατηρω
παρατηρούνται	παρατηρω
παρατηρώ	παρατηρω
παρατυπίες	παρατυπια
παραφθορά	παραφθορα
παραφράστηκε	παραφραζω
παραχαράκτες	παραχαρακτης
παραχωρηθεί	παραχωρω
παραχωρούνται	παραχωρω
παραχώρησε	παραχωρω
παραχωρήσεων	παραχωρηση
παραϊατρικό	παραιατρικος
παρελθόν	παρελθον
παρελθόντος	παρελθον
παρέμβουμε	παρεμβαινω
παρενέβαιναν	παρεμβαινω
παρεμποδίζει	παρεμποδιζω
παρεμφερείς	παρεμφερης
παρευρεθούν	παρευρισκομαι
παρευρισκόμαστε	παρευρισκομαι
παρθένιος	παρθενιος
παροικία	παροικια
παρουσία	παρουσια
παρουσίας	παρουσια
παρουσίασή	παρουσιαση
παρουσίασαν	παρουσιαζω
παρουσίασε	παρουσιαζω
παρουσιάζει	παρουσιαζω
παρουσιάζεται	παρουσιαζω
παρουσιάζουν	παρουσιαζω
παρουσιάσατε	παρουσιαζω
παρουσιάσει	παρουσιαζω
παρουσιάσουμε	παρουσιαζω
παρουσιάστηκαν	παρουσιαζω
παρουσιάσω	παρουσιαζω
παρουσιαστεί	παρουσιαζω
παροχή	παροχη
παροχής	παροχη
παρτίδα	παρτιδα
παρτίδες	παρτιδα
παρυφές	παρυφη
παρόλα	παρολα
παρόλα	παρολο
παρόλο	παρολο
παρόλα	παρολο
παρόλο	παρολο
παρομοίως	παρομοια
παρόμοιο	παρομοιος
παρόμοια	παρομοιος
παρόμοιες	παρομοιος
παρόν	παρον
παρόν	παρον
παρόντος	παρον
παρόντος	παρον
παρούσα	παρων
παρούσας	παρων
παρόντες	παρων
πάντων	πας
πάση	πας
πασά	πασας
πασίγνωστο	πασιγνωστος
πατάτα	πατατα
πατάτας	πατατα
πατατοπαραγωγοί	πατατοπαραγωγοι
πατατοπαραγωγός	πατατοπαραγωγος
πατρίδα	πατριδα
παύλο	παυλος
παύλος	παυλος
παύλου	παυλος
παύση	παυση
πάψει	παυω
παύει	παυω
παύσει	παυω
έπεισαν	πειθω
πείσει	πειθω
πείσουν	πειθω
πείστηκε	πειθω
πείνα	πεινα
πείνας	πεινα
πείρα	πειρα
πειράματα	πειραμα
πεδία	πεδιο
πεδίο	πεδιο
πεδίων	πεδιο
πεδιάδα	πεδιαδα
πέθανε	πεθαινω
πέθαναν	πεθαινω
πέθανε	πεθαινω
πεθάνει	πεθαινω
πεθαίνουν	πεθαινω
πειραιώς	πειραιευς
πειραματικών	πειραματικος
πειρασμό	πειρασμος
πειρατικές	πειρατικος
πειστικά	πειστικος
πεκίνο	πεκινο
πελάτες	πελατης
πελοποννησιακού	πελοποννησιακος
πεντάγωνο	πενταγωνος
πενταγώνου	πενταγωνος
πεντάμηνη	πενταμηνος
πεντακάθαρα	πεντακαθαρος
πεντακάθαρες	πεντακαθαρος
πεποίθηση	πεποιθηση
περέιρα	περειρα
περίεργα	περιεργος
περίεργη	περιεργος
περίθαλψης	περιθαλψη
περίοδο	περιοδος
περίοδος	περιοδος
περιόδου	περιοδος
περιόδους	περιοδος
περίπατο	περιπατος
περιπάτους	περιπατος
περίπλοκο	περιπλοκος
περίπου	περιπου
περίπτωση	περιπτωση
περίπτωσης	περιπτωση
περιπτώσεις	περιπτωση
περιπτώσεων	περιπτωση
περίσταση	περισταση
περιστάσεις	περισταση
περίφημες	περιφημος
περίχωρα	περιχωρα
περαιτέρω	περαιτερω
περασμένη	περασμενος
περασμένο	περασμενος
περασμένου	περασμενος
περιέλθει	περιερχομαι
περιήλθε	περιερχομαι
περιέχει	περιεχω
περιέχουν	περιεχω
περιήγηση	περιηγηση
περιβάλλοντος	περιβαλλον
περιβάλλον	περιβαλλον
περιβάλλοντος	περιβαλλον
περιβάλλουν	περιβαλλω
περιβάλλον	περιβαλλων
περιβαλλοντικά	περιβαλλοντικος
περιβαλλοντικές	περιβαλλοντικος
περιβαλλοντική	περιβαλλοντικος
περιβαλλοντικούς	περιβαλλοντικος
περιβαλλοντικών	περιβαλλοντικος
περιβόητη	περιβοητος
περιέγραφε	περιγραφω
περιγράφει	περιγραφω
περιεκτικότερες	περιεκτικος
περιεχομένου	περιεχομενο
περιεχόμενο	περιεχομενο
περιηγητικούς	περιηγητικος
περιηγηθεί	περιηγουμαι
περιθωριοποιεί	περιθωριοποιω
περιθώρια	περιθωριο
περιθώριο	περιθωριο
περικοπές	περικοπη
περικοπή	περικοπη
περικοπών	περικοπη
περικοπούν	περικοβω
περιλαμβάνει	περιλαμβανω
περιλαμβάνεται	περιλαμβανω
περιλαμβάνονται	περιλαμβανω
περιλαμβάνονταν	περιλαμβανω
περιληφθεί	περιλαμβανω
περιληφθούν	περιλαμβανω
περιμένει	περιμενω
περιμένουμε	περιμενω
περιμένουν	περιμενω
περιμένω	περιμενω
περιόδευε	περιοδευω
περιοριστήκαμε	περιοριζω
περιορίζει	περιοριζω
περιορίζεται	περιοριζω
περιορίσουν	περιοριζω
περιορισμένη	περιοριζω
περιοριστεί	περιοριζω
περιοριστώ	περιοριζω
περιορισμοί	περιορισμος
περιορισμού	περιορισμος
περιορισμούς	περιορισμος
περιορισμό	περιορισμος
περιοριστικές	περιοριστικος
περιοριστικούς	περιοριστικος
περιουσίας	περιουσια
περιουσιολόγιο	περιουσιολογιο
περιοχές	περιοχη
περιοχή	περιοχη
περιοχής	περιοχη
περιοχών	περιοχη
περιπέτεια	περιπετεια
περιπολούν	περιπολω
περιπτώσει	περιπτωσει
περιστέρα	περιστερα
περιστατικό	περιστατικο
περιστοιχίζουν	περιστοιχιζω
περιφέρεια	περιφερεια
περιφέρειας	περιφερεια
περιφέρειες	περιφερεια
περιφερειακής	περιφερειακος
περιφερειακός	περιφερειακος
περιφερειακή	περιφερειακος
πέρασε	περνω
πέρασαν	περνω
πέρασε	περνω
περάσει	περνω
περάσουμε	περνω
περάσουν	περνω
περνά	περνω
περνούν	περνω
περνούσαν	περνω
περπατάει	περπατω
περσινή	περσινος
περσινής	περσινος
περυσινά	περσινος
περυσινή	περσινος
πετάλι	πεταλι
πετρέλαιο	πετρελαιο
πετρελαίου	πετρελαιο
πετρούπολης	πετρουπολη
πέτυχαν	πετυχαινω
πέτυχε	πετυχαινω
πετύχαμε	πετυχαινω
πετύχουμε	πετυχαινω
πετάει	πετω
πετάχτηκαν	πετω
πετούσε	πετω
πεύκα	πευκο
πηγάζει	πηγαζω
πηγάζει	πηγαζω
πηγές	πηγη
πηγές	πηγη
πηγή	πηγη
πάει	πηγαινω
πήγε	πηγαινω
πηγαίνουμε	πηγαινω
πηγαίνουν	πηγαινω
πηδάλιο	πηδαλιο
πιάσουν	πιανω
πιάστηκαν	πιανω
πιαστεί	πιανω
πίεσαν	πιεζω
πιέσει	πιεζω
πια	πια
πιθανολογείται	πιθανολογω
πιθανά	πιθανος
πιθανούς	πιθανος
πιθανό	πιθανος
πιθανών	πιθανος
πιθανότητές	πιθανοτητα
πιθανότητα	πιθανοτητα
πιθανότητες	πιθανοτητα
πιθανότητες	πιθανοτητα
πιθανόν	πιθανως
πιθανότατα	πιθανως
πιθανώς	πιθανως
πιλάφ	πιλαφ
πιο	πιο
πιο	πιο
πιπέρι	πιπερι
πιστεύεται	πιστευεται
πίστευε	πιστευω
πιστεύουμε	πιστευω
πιστεύω	πιστευω
πίστευαν	πιστευω
πιστέψουν	πιστευω
πιστεύει	πιστευω
πιστεύετε	πιστευω
πιστεύουμε	πιστευω
πιστεύουν	πιστευω
πιστεύω	πιστευω
πιστοποιητικού	πιστοποιητικο
πιστοποιητικό	πιστοποιητικο
πιστές	πιστος
πιστοί	πιστος
πλάι	πλαι
πλάτος	πλατος
έπλεκε	πλεκω
πλέον	πλεον
πλέον	πλεον
πλήγμα	πληγμα
πλήθος	πληθος
πλήρες	πληρης
πλήρη	πληρης
πλήρης	πληρης
πλήρους	πληρης
πληρέστερα	πληρης
πληρωμάτων	πληρωμα
πλήρως	πληρως
έπληξαν	πληττω
έπληξε	πληττω
επλήγησαν	πληττω
πλήξει	πληττω
πλαίσια	πλαισιο
πλαίσιο	πλαισιο
πλαισίου	πλαισιο
πλαγιές	πλαγια
πλακόστρωτα	πλακοστρωτος
πλατάνια	πλατανι
πλατεία	πλατεια
πλατείες	πλατεια
πλείστον	πλειστος
πλειοψηφία	πλειοψηφια
πλειοψηφίας	πλειοψηφια
πλεονέκτημα	πλεονεκτημα
πλεονεκτήματα	πλεονεκτημα
πλεονεκτημάτων	πλεονεκτημα
πλευρά	πλευρα
πλευράς	πλευρα
πλευρές	πλευρα
πλευρό	πλευρο
πληγέντες	πληγεις
πληθυσμιακούς	πληθυσμιακος
πληθυσμοί	πληθυσμος
πληθυσμού	πληθυσμος
πληθυσμούς	πληθυσμος
πληθυσμό	πληθυσμος
πληθυσμός	πληθυσμος
πληθωρισμού	πληθωρισμος
πλημμελειοδικών	πλημμελειοδικης
πληροφορίες	πληροφορια
πληροφορίες	πληροφορια
πληροφοριών	πληροφορια
πληροφόρησε	πληροφορω
πληροφόρησης	πληροφορηση
πληρωμές	πληρωμη
πληροί	πληρω
πληρούν	πληρω
πλήρωσε	πληρωνω
πληρώνουν	πληρωνω
πληρώσει	πληρωνω
πληρώσουν	πληρωνω
πλησιέστερα	πλησιον
πλησιάζουν	πλησιαζω
πλοίο	πλοιο
πλοία	πλοιο
πλοίο	πλοιο
πλοίου	πλοιο
πλοίων	πλοιο
πλουραλισμό	πλουραλισμος
πλουραλιστικής	πλουραλιστικος
πλούσια	πλουσιος
πλούσια	πλουσιος
πλούσιες	πλουσιος
πλώρη	πλωρη
πνιγμένες	πνιγω
πνεύμα	πνευμα
πνεύμονες	πνευμονας
ποίησή	ποιηση
ποδηλασία	ποδηλασια
ποδηλασίας	ποδηλασια
ποιητή	ποιητης
ποικίλει	ποικιλλω
ποικίλες	ποικιλος
ποικιλότητας	ποικιλοτητα
ποινές	ποινη
ποινή	ποινη
ποινής	ποινη
ποινικό	ποινικος
ποινικές	ποινικος
ποινικής	ποινικος
ποινικούς	ποινικος
ποινικό	ποινικος
ποινικών	ποινικος
ποιον	ποιος
ποιοτικής	ποιοτικος
ποιοτικών	ποιοτικος
ποιότητα	ποιοτητα
ποιότητας	ποιοτητα
πολίτευμα	πολιτευμα
πολίτες	πολιτης
πολίτη	πολιτης
πολιτών	πολιτης
πολεμίστρες	πολεμιστρα
πολεμικά	πολεμικος
πολεμικές	πολεμικος
πολεμικό	πολεμικος
πολεμικών	πολεμικος
πολέμησαν	πολεμω
πολέμησε	πολεμω
πολεμούσαν	πολεμω
πολιορκία	πολιορκια
πολιορκίες	πολιορκια
πολιούχου	πολιουχος
πολιτείες	πολιτεια
πολιτειών	πολιτεια
πολιτεία	πολιτεια
πολιτείες	πολιτεια
πολιτειών	πολιτεια
πολιτειακής	πολιτειακος
πολιτικά	πολιτικα
πολιτικής	πολιτικη
πολιτικές	πολιτικη
πολιτική	πολιτικη
πολιτική	πολιτικη
πολιτικής	πολιτικη
πολιτικής	πολιτικη
πολιτικών	πολιτικη
πολιτικών	πολιτικη
πολιτικής	πολιτικος
πολιτικής	πολιτικος
πολιτικά	πολιτικος
πολιτικές	πολιτικος
πολιτική	πολιτικος
πολιτικής	πολιτικος
πολιτικοί	πολιτικος
πολιτικού	πολιτικος
πολιτικού	πολιτικος
πολιτικούς	πολιτικος
πολιτικούς	πολιτικος
πολιτικό	πολιτικος
πολιτικών	πολιτικος
πολιτισμικά	πολιτισμικος
πολιτιστικά	πολιτιστικος
πολιτιστική	πολιτιστικος
πολιτιστικούς	πολιτιστικος
πολιτική	πολιτκος
πολυάριθμα	πολυαριθμος
πολυάριθμων	πολυαριθμος
πολυετούς	πολυετης
πολύ	πολυ
περισσότερο	πολυ
πολύ	πολυ
πολύγνωτου	πολυγνωτος
πολύπλευρη	πολυπλευρος
πολύπλοκα	πολυπλοκος
περισσότερα	πολυς
περισσότεροι	πολυς
πολλά	πολυς
πολλές	πολυς
πολλοί	πολυς
περισσοτέρων	πολυς
περισσότερα	πολυς
περισσότερες	πολυς
περισσότερη	πολυς
περισσότερης	πολυς
περισσότερο	πολυς
περισσότεροι	πολυς
περισσότερος	πολυς
περισσότερους	πολυς
πολλά	πολυς
πολλές	πολυς
πολλή	πολυς
πολλοί	πολυς
πολλούς	πολυς
πολλών	πολυς
πολύν	πολυς
πολύτοξα	πολυτοξος
πολύχρωμους	πολυχρωμος
ποντάρουμε	πονταρω
ποντίκια	ποντικι
πορεία	πορεια
πορείας	πορεια
πορτογάλων	πορτογαλος
πορτογαλική	πορτογαλικος
ποσειδώνια	ποσειδωνιος
ποσοστιαίες	ποσοστιαιος
ποσοστά	ποσοστο
ποσοστά	ποσοστο
ποσοστού	ποσοστο
ποσοστό	ποσοστο
ποσά	ποσο
ποσού	ποσο
ποσό	ποσο
ποσόν	ποσο
ποσών	ποσο
ποσότητες	ποσοτητα
ποτάμι	ποταμι
ποτέ	ποτε
ποτέ	ποτε
ποταμού	ποταμος
ποταμούς	ποταμος
ποταμό	ποταμος
ποταμός	ποταμος
που	που
πουλιά	πουλι
πουλιών	πουλι
πουλερικά	πουλερικο
πουλά	πουλω
πουλάμε	πουλω
πουλούσαμε	πουλω
πού	που
πούσκιν	πουσκιν
πούτιν	πουτιν
πούτιν	πουτιν
πράγας	πραγα
πράγμα	πραγμα
πράγματα	πραγμα
πράγματι	πραγματι
πράγματι	πραγματι
πράκτορες	πρακτορας
πρακτόρων	πρακτορας
πράξεις	πραξη
πράξεών	πραξη
πράξη	πραξη
πράσινο	πρασινο
πρασίνων	πρασινος
πράσινο	πρασινος
έπραξαν	πραττω
έπραξε	πραττω
πράξαμε	πραττω
πρέπει	πρεπει
έπρεπε	πρεπει
πρέπει	πρεπει
πρέσβη	πρεσβης
πρέσβης	πρεσβης
πρέσπα	πρεσπες
πρίγκηπας	πριγκηπας
πρίγκιπα	πριγκιπας
πρίγκιπας	πριγκιπας
πρίσμα	πρισμα
πραγμάτωση	πραγματωση
πραγματικά	πραγματικα
πραγματικά	πραγματικα
πραγματικά	πραγματικα
πραγματικά	πραγματικος
πραγματικές	πραγματικος
πραγματική	πραγματικος
πραγματικούς	πραγματικος
πραγματικότητα	πραγματικοτητα
πραγματικότητες	πραγματικοτητα
πραγματοποίηση	πραγματοποιηση
πραγματοποίησαν	πραγματοποιω
πραγματοποίησε	πραγματοποιω
πραγματοποιήθηκαν	πραγματοποιω
πραγματοποιήθηκε	πραγματοποιω
πραγματοποιήσουν	πραγματοποιω
πραγματοποιεί	πραγματοποιω
πραγματοποιείται	πραγματοποιω
πραγματοποιηθεί	πραγματοποιω
πραγματοποιηθούν	πραγματοποιω
πραγματοποιούν	πραγματοποιω
πραγματοποιούνται	πραγματοποιω
πραγματοποιούνταν	πραγματοποιω
πρακτικές	πρακτικη
πρακτική	πρακτικος
πρακτικό	πρακτικος
πρακτικών	πρακτικος
πρακτορεία	πρακτορεια
πρακτορείο	πρακτορειο
πρακτορείου	πρακτορειο
πρακτορεία	πρακτορειο
πρακτορείο	πρακτορειο
πριν	πριν
πριν	πριν
προαχθούν	προαγω
προάσπιση	προασπιση
προέλευσης	προελευση
προέλθει	προερχομαι
προέρχεται	προερχομαι
προήλθε	προερχομαι
προανήγγειλε	προαναγγελλω
προαναφερθέντες	προαναφερθεις
προέβαλε	προβαλλω
προβάλλει	προβαλλω
προβάλουν	προβαλλω
προβληθεί	προβαλλω
πρόβαλε	προβαλλω
προέβη	προβαινω
προβαίνει	προβαινω
προβεί	προβαινω
προβούμε	προβαινω
προβούν	προβαινω
προβλέπει	προβλεπω
προβλέπεται	προβλεπω
προβλέπει	προβλεπω
προβλέπεται	προβλεπω
προβλέπονται	προβλεπω
προβλεπόταν	προβλεπω
προβλεφθεί	προβλεπω
προβλήτα	προβλητα
προβλεπόμενες	προβλεπομενος
προβλεπόμενου	προβλεπομενος
προβληματική	προβληματικος
προβληματισμού	προβληματισμος
προβληματισμούς	προβληματισμος
προβληματισμό	προβληματισμος
προγραμματιστεί	προγραμματιζω
προγραμματικές	προγραμματικος
προγραμματική	προγραμματικος
προγραμματισμένα	προγραμματισμενος
προδιαγραφών	προδιαγραφη
προδιαγραφές	προδιαγραφη
προδιαγραφών	προδιαγραφη
προδικάσουν	προδικαζω
προδικαστικό	προδικαστικος
προδοσία	προδοσια
προεδρία	προεδρια
προεδρίας	προεδρια
προεδρία	προεδρια
προεδρίας	προεδρια
προεδρείο	προεδρειο
προεδρεία	προεδρειο
προεδρείο	προεδρειο
προεδρεύοντα	προεδρευων
προεδρεύοντα	προεδρευων
προεδρικές	προεδρικος
προεδρική	προεδρικος
προεδρικό	προεδρικος
προεδρικός	προεδρικος
προεδρικών	προεδρικος
προειδοποίηση	προειδοποιηση
προειδοποίησης	προειδοποιηση
προειδοποιητικής	προειδοποιητικος
προειδοποιήσει	προειδοποιω
προειδοποιεί	προειδοποιω
προειδοποιούνται	προειδοποιω
προεκλογική	προεκλογικος
προεκλογικής	προεκλογικος
προενταξιακή	προενταξιακη
προεξάρχοντες	προεξαρχων
προερχόμενοι	προερχομενος
προετοιμάζουν	προετοιμαζω
προετοιμασία	προετοιμασια
προηγουμένως	προηγουμενως
προηγουμένως	προηγουμενως
προηγήθηκαν	προηγουμαι
προηγηθεί	προηγουμαι
προηγουμένου	προηγουμενος
προηγουμένων	προηγουμενος
προηγούμενα	προηγουμενος
προηγούμενες	προηγουμενος
προηγούμενη	προηγουμενος
προηγούμενης	προηγουμενος
προηγούμενο	προηγουμενος
προηγούμενου	προηγουμενος
προθεσμίας	προθεσμια
προκάτοχό	προκατοχος
προκήρυξη	προκηρυξη
προκαθήμενος	προκαθημενος
προκλήθηκε	προκαλω
προκάλεσε	προκαλω
προκαλέσει	προκαλω
προκαλέσουν	προκαλω
προκαλεί	προκαλω
προκαλούνται	προκαλω
προκαλώ	προκαλω
προκαλώντας	προκαλω
προκατέβαλε	προκαταβαλλω
προκαταβλήθηκαν	προκαταβαλλω
προκαταρκτική	προκαταρκτικος
προκείμενη	προκειμενος
προκειμένη	προκειμενος
προκηρύξουν	προκηρυσσω
προκλητική	προκλητικος
προκρίθηκε	προκρινω
προκριθεί	προκρινω
προκριματικές	προκριματικος
προκριματικών	προκριματικος
προκύπτει	προκυπτω
προκύπτουν	προκυπτω
προκύψει	προκυπτω
προκύψουν	προκυπτω
προλάβουμε	προλαβαινω
πρόλαβαν	προλαβαινω
προμήθειες	προμηθεια
προμηθειών	προμηθεια
προμαγειρεμένα	προμαγειρεμενος
προμηθεύεται	προμηθευω
προμηθεύονται	προμηθευω
προνόμιο	προνομιο
προξενήσει	προξενω
προξενούν	προξενω
προοιμίου	προοιμιο
προοδεύσει	προοδευω
προοπτικές	προοπτικη
προοπτική	προοπτικη
προοπτικής	προοπτικη
προορισμούς	προορισμος
προορισμό	προορισμος
προπάντων	προπαντων
προπαγάνδα	προπαγανδα
προπαγανδιστικές	προπαγανδιστικος
προπαντός	προπαντος
προπαρασκευαστικές	προπαρασκευαστικος
προπαρασκευαστικής	προπαρασκευαστικος
προπολεμικού	προπολεμικος
προσάρτηση	προσαρτηση
προσάρτησης	προσαρτηση
προσέγγιση	προσεγγιση
προσέγγισης	προσεγγιση
προσήλθαν	προσερχομαι
προσέξει	προσεχω
προσέξουμε	προσεχω
προσήκουσες	προσηκων
προσήλωση	προσηλωση
προσανατολισμένη	προσανατολιζω
προσανατολισμό	προσανατολισμος
προσαρμογής	προσαρμογη
προσαρμοσμένη	προσαρμοζω
προσάρτησε	προσαρτω
προσβάσιμα	προσβασιμος
προσβάσιμη	προσβασιμος
προσγείωση	προσγειωση
προσδίδουν	προσδιδω
προσδιοριστεί	προσδιοριζω
προσδιορισμού	προσδιορισμος
προσδοκία	προσδοκια
προσδοκίες	προσδοκια
προσδοκούμε	προσδοκω
προσδόκιμο	προσδοκιμος
προσεγγίζει	προσεγγιζω
προσεγγίζουμε	προσεγγιζω
προσεγγίσει	προσεγγιζω
προσελκύσει	προσελκυω
προσεύχεται	προσευχομαι
προσεύχονται	προσευχομαι
πρόσθεσε	προσθετω
προστέθηκε	προσθετω
προστεθεί	προσθετω
προστεθούν	προσθετω
πρόσθεσε	προσθετω
προσκαλέσουμε	προσκαλω
προσέκρουσε	προσκρουω
προσληφθεί	προσλαμβανω
προσληφθούν	προσλαμβανω
προσοχή	προσοχη
προσπάθειές	προσπαθεια
προσπάθεια	προσπαθεια
προσπάθειες	προσπαθεια
προσπαθειών	προσπαθεια
προσπάθησα	προσπαθω
προσπάθησαν	προσπαθω
προσπάθησε	προσπαθω
προσπαθήσαμε	προσπαθω
προσπαθήσει	προσπαθω
προσπαθήσετε	προσπαθω
προσπαθήσουμε	προσπαθω
προσπαθήσουν	προσπαθω
προσπαθεί	προσπαθω
προσπαθούμε	προσπαθω
προσπαθούν	προσπαθω
προσπαθούσαν	προσπαθω
προσπαθώντας	προσπαθω
προσπέρασαν	προσπερνω
προστάτιδες	προστατιδα
προστασίας	προστασια
προστασία	προστασια
προστασίας	προστασια
προστασίες	προστασια
προστατευόμενη	προστατευομενος
προστατέψει	προστατευω
προστατευθεί	προστατευω
προστατεύουν	προστατευω
προστιθέμενη	προστιθεμενος
προσυπέγραψαν	προσυπογραφω
προσέφερε	προσφερω
προσφέρει	προσφερω
προσφέρεται	προσφερω
προσφέρθηκαν	προσφερω
προσφέρονται	προσφερω
προσφέρουν	προσφερω
προσφερθεί	προσφερω
προσφέροντες	προσφερων
προσφύγουν	προσφευγω
προσφορά	προσφορα
προσφοράς	προσφορα
προσφορές	προσφορα
προσφορών	προσφορα
προσχώρησαν	προσχωρω
προσχωρήσει	προσχωρω
προσχώρησαν	προσχωρω
προσχώρησε	προσχωρω
προσχώρησής	προσχωρηση
προσχώρηση	προσχωρηση
προσωπικά	προσωπικα
προσωπικά	προσωπικα
προσωπικό	προσωπικο
προσωπική	προσωπικος
προσωπικής	προσωπικος
προσωπικοτήτων	προσωπικοτητα
προσωπικότητα	προσωπικοτητα
προσωπικότητες	προσωπικοτητα
προσωρινά	προσωρινα
προσωρινή	προσωρινος
προσωρινής	προσωρινος
προσωρινή	προσωρινος
προσωρινό	προσωρινος
προσόντα	προσον
προσόντων	προσον
προτερήματα	προτερημα
προτίθεται	προτιθεμαι
προτίμηση	προτιμηση
προτάθηκαν	προτεινω
προτείνω	προτεινω
πρότεινα	προτεινω
πρότεινε	προτεινω
προταθεί	προτεινω
προτείνει	προτεινω
πρότεινα	προτεινω
πρότειναν	προτεινω
πρότεινε	προτεινω
προτεινόμενα	προτεινομενος
προτεινόμενες	προτεινομενος
προτεινόμενο	προτεινομενος
προτεραιότητα	προτεραιοτητα
προτεραιότητας	προτεραιοτητα
προτεραιότητες	προτεραιοτητα
προτιμά	προτιμω
προτιμούσαν	προτιμω
προέτρεπα	προτρεπω
προέτρεψαν	προτρεπω
προφανώς	προφανως
προφανώς	προφανως
προφορικά	προφορικα
προφορική	προφορικος
προφυλακίστηκαν	προφυλακιζω
προφυλακιστούν	προφυλακιζω
προχωρά	προχωρω
προχωρήσει	προχωρω
προχωρήσετε	προχωρω
προχωρήσουμε	προχωρω
προχωρήσουν	προχωρω
προχώρησε	προχωρω
προωθεί	προωθω
προωθηθεί	προωθω
προωθούν	προωθω
προωθούνται	προωθω
προώθησαν	προωθω
προϊστορικό	προιστορικος
προϊόν	προιον
προϊόντα	προιον
προϊόντος	προιον
προϊόντων	προιον
προϋποθέτει	προυποθετω
προϋπολογισμού	προυπολογισμος
προϋπολογισμού	προυπολογισμος
προϋπολογισμό	προυπολογισμος
προϋπολογισμός	προυπολογισμος
προϋπολογισμών	προυπολογισμος
προϋποθέσεις	προυποθεση
προϋπόθεση	προυποθεση
προώθησή	προωθηση
προώθησής	προωθηση
προώθηση	προωθηση
προώθησης	προωθηση
πρωί	πρωι
πρωθυπουργού	πρωθυπουργος
πρωθυπουργό	πρωθυπουργος
πρωθυπουργός	πρωθυπουργος
πρωθυπουργού	πρωθυπουργος
πρωθυπουργό	πρωθυπουργος
πρωθυπουργός	πρωθυπουργος
πρωσία	πρωσια
πρωσίας	πρωσια
πρωταρχική	πρωταρχικος
πρωταρχικής	πρωταρχικος
πρωτεύουσα	πρωτευουσα
πρωτεύουσας	πρωτευουσα
πρωτεύουσες	πρωτευουσα
πρωτεύοντα	πρωτευων
πρωτοβάθμια	πρωτοβαθμιος
πρωτοβουλία	πρωτοβουλια
πρωτοβουλίας	πρωτοβουλια
πρωτοβουλίες	πρωτοβουλια
πρωτοβουλιών	πρωτοβουλια
πρωτοκατοικήθηκε	πρωτοκατοικω
πρωτοκατοικήθηκε	πρωτοκατοικω
πρωτοπόρος	πρωτοπορος
πρωτοπόρων	πρωτοπορος
πρωτοστάτες	πρωτοστατης
πρωτοστατούσε	πρωτοστατω
πρωτοσύγγελοι	πρωτοσυγγελος
πρωτότυπη	πρωτοτυπος
πρόβλεψη	προβλεψη
προβλήματα	προβλημα
προβλήματος	προβλημα
πρόβλημα	προβλημα
προγραμμάτων	προγραμμα
προγράμματα	προγραμμα
προγράμματος	προγραμμα
προγράμματός	προγραμμα
προγραμμάτων	προγραμμα
πρόγραμμα	προγραμμα
πρόδρομος	προδρομος
προέδρου	προεδρος
προέδρων	προεδρος
πρόεδρε	προεδρος
πρόεδρο	προεδρος
πρόεδρος	προεδρος
πρόεδρός	προεδρος
προέδρου	προεδρος
προέδρους	προεδρος
πρόεδρο	προεδρος
πρόεδρος	προεδρος
προθέσεις	προθεση
πρόθυμες	προθυμος
πρόκειται	προκειται
επρόκειτο	προκειται
πρόκειται	προκειται
προκλήσεις	προκληση
πρόκληση	προκληση
πρόκλησης	προκληση
πρόκριση	προκριση
προκρίτου	προκριτος
πρόληψη	προληψη
πρόληψης	προληψη
πρόνοια	προνοια
πρόντι	προντι
πρόοδος	προοδος
προόδου	προοδος
πρόοδο	προοδος
πρόοδοι	προοδος
πρόοδος	προοδος
πρόποδές	προποδες
πρόσβασή	προσβαση
πρόσβαση	προσβαση
πρόσβασης	προσβαση
πρόσθετα	προσθετος
πρόσθετες	προσθετος
πρόσθετο	προσθετος
επρόσκειτο	προσκειμαι
προσκλήσεις	προσκληση
πρόσκληση	προσκληση
προσκόπων	προσκοπος
πρόσκρουσης	προσκρουση
πρόστιμο	προστιμο
πρόσφατα	προσφατα
πρόσφατη	προσφατος
πρόσφυγες	προσφυγας
προσώπων	προσωπο
πρόσωπα	προσωπο
προτάσεις	προταση
προτάσεων	προταση
πρότασή	προταση
πρόταση	προταση
πρότασης	προταση
πρότινος	προτινος
προτύπων	προτυπο
πρότυπα	προτυπο
πρότυπο	προτυπο
πρώην	πρωην
πρώην	πρωην
πρώτα	πρωτα
πρώτιστα	πρωτιστα
πρώτον	πρωτον
πρώτον	πρωτον
πρώτων	πρωτος
πτέρυγας	πτερυγα
πτήση	πτηση
πτηνών	πτηνο
πτοούνται	πτοω
πτυχές	πτυχη
πτυχή	πτυχη
πτυχία	πτυχιο
πτώματα	πτωμα
πτώση	πτωση
πτώχευση	πτωχευση
πυλώνα	πυλωνας
πυρ	πυρ
πυρά	πυρ
πυρός	πυρ
πυρήνα	πυρηνας
πυρηνικά	πυρηνικος
πυρηνικές	πυρηνικος
πυρηνικής	πυρηνικος
πυρηνικού	πυρηνικος
πυρηνικό	πυρηνικος
πυριτιδαποθήκη	πυριτιδαποθηκη
πυροβολισμούς	πυροβολισμος
πυροβόλα	πυροβολο
πυροδοτεί	πυροδοτω
πυροδότησαν	πυροδοτω
πυροσβέστες	πυροσβεστης
πωλ	πωλ
πωλεί	πωλω
πόδια	ποδι
πολέμου	πολεμος
πόλεμο	πολεμος
πόλεμοι	πολεμος
πόλεμος	πολεμος
πολέμου	πολεμος
πολέμους	πολεμος
πόλεμο	πολεμος
πόλεμος	πολεμος
πόλεις	πολη
πόλεων	πολη
πόλη	πολη
πόλη	πολη
πόλης	πολη
πόλο	πολος
πόλωση	πολωση
πόροι	πορος
πόρους	πορος
πόρων	πορος
πόσο	ποσο
πότε	ποτε
πυθίου	πυθιος
πύλη	πυλη
πύλη	πυλη
πυραύλων	πυραυλος
πύργοι	πυργος
πωλήσεις	πωληση
πώληση	πωληση
πώς	πως
ράινεκ	ραινεκ
ράιχ	ραιχ
ράιχσμαρκ	ραιχσμαρκ
ράλλης	ραλλης
ράφτινγκ	ραφτινγκ
ρέγιες	ρεγιες
ρένια	ρενια
ρήτρα	ρητρα
ρίκ	ρικ
ρίτσαρντσον	ριτσαρντσον
έριξα	ριχνω
ρίξουν	ριχνω
ρίχνοντας	ριχνω
ρίχτηκαν	ριχνω
ραβενής	ραβενη
ραδιοφωνία	ραδιοφωνια
ραντάρ	ρανταρ
ραούλ	ραουλ
ρεβάνς	ρεβανς
ρεκόρ	ρεκορ
ρεκόρ	ρεκορ
ρενάτο	ρενατο
ρεπουμπλικανικού	ρεπουμπλικανικος
ρεπουμπλικανικού	ρεπουμπλικανικος
ρεπουμπλικανοί	ρεπουμπλικανος
ρεπουμπλικανούς	ρεπουμπλικανος
ρεπουμπλικανών	ρεπουμπλικανος
ρεπόρτερς	ρεπορτερς
ρευστό	ρευστος
ρευστότητα	ρευστοτητα
ρεύμα	ρευμα
ρητά	ρητα
ρητή	ρητος
ρητής	ρητος
ρητώς	ρητως
ριζικά	ριζικα
ριζοσπάστης	ριζοσπαστης
ρικ	ρικ
ριχάρδο	ριχαρδος
ροή	ροη
ροδόλειβος	ροδολειβος
ροδόπης	ροδοπη
ροζίτσκι	ροζιτσκι
ρομπέρ	ρομπερ
ρον	ρον
ρουκέτες	ρουκετα
ρουβλίων	ρουβλι
ρούβλιων	ρουβλιων
ρτ	ρτ
ρυθμίστηκε	ρυθμιζω
ρυθμιστικό	ρυθμιστικος
ρυθμού	ρυθμος
ρυθμούς	ρυθμος
ρυθμός	ρυθμος
ρυπογόνα	ρυπογονος
ρυπογόνους	ρυπογονος
ρωμαϊκή	ρωμαικος
ρωμαϊκής	ρωμαικος
ρωμαϊκά	ρωμαικος
ρωμαϊκή	ρωμαικος
ρωμαϊκών	ρωμαικος
ρωσίας	ρωσια
ρωσικής	ρωσικη
ρωσικά	ρωσικος
ρωσική	ρωσικος
ρωτήσατε	ρωτω
ρωτήσω	ρωτω
ρώτησε	ρωτω
ρόκα	ροκα
ρόλο	ρολος
ρόλος	ρολος
ρόλου	ρολος
ρόμνεϊ	ρομνει
ρυθμίσεις	ρυθμιση
ρυθμίσεων	ρυθμιση
ρύθμιση	ρυθμιση
ρυπάνσεων	ρυπανση
ρύπανση	ρυπανση
ρύπανσης	ρυπανση
ρώμη	ρωμη
ρώμης	ρωμη
ρώσος	ρωσος
ρώσους	ρωσος
ρώσο	ρωσος
ρώσους	ρωσος
ρώσων	ρωσος
σ	σε
σάββας	σαββας
σάββατο	σαββατο
σάλο	σαλος
σάλτσα	σαλτσα
σάλτσες	σαλτσα
σέβονται	σεβομαι
σεβαστήκαμε	σεβομαι
σεβαστούμε	σεβομαι
σεβρών	σεβρες
σένγκεν	σενγκεν
σέρβοι	σερβος
σέρβων	σερβος
σερρών	σερρες
σήμα	σημα
σήμερα	σημερα
σήμερα	σημερα
σίγουρα	σιγουρα
σίτι	σιτι
σίτυ	σιτυ
σίφνου	σιφνος
σίφωνες	σιφωνας
σιφώνων	σιφωνας
σαλέχ	σαλεχ
σαλιντάρνοστ	σαλινταρνοστ
σαμψών	σαμψων
σαν	σαν
σαν	σαν
σαντάτ	σαντατ
σαντόρουμ	σαντορουμ
σαρ	σαρ
σαρκοζί	σαρκοζι
σαφήνεια	σαφηνεια
σαφές	σαφης
σαφέστατο	σαφης
σαφέστερα	σαφης
σαφέστερη	σαφης
σαφή	σαφης
σαφής	σαφης
σαφείς	σαφης
σαφώς	σαφως
σβηστεί	σβηνω
σεΐχ	σειχ
σείοντας	σειω
σεβασμού	σεβασμος
σεβασμό	σεβασμος
σεβασμός	σεβασμος
σεβαστές	σεβαστος
σειρά	σειρα
σεισμόπληκτους	σεισμοπληκτος
σεισμού	σεισμος
σεισμό	σεισμος
σεισμός	σεισμος
σελάλ	σελαλ
σελίδα	σελιδα
σελίδων	σελιδα
σενούντα	σενουντα
σενούσι	σενουσι
σεπτεμβρίου	σεπτεμβριος
σεργκέι	σεργκει
σερεμέτιεβο	σερεμετιεβο
σημάδι	σημαδι
σημάδια	σημαδι
σημαία	σημαια
σήμαινε	σημαινω
σημάνει	σημαινω
σημαίνει	σημαινω
σημαίνουν	σημαινω
σημαντικά	σημαντικα
σημαντικό	σημαντικος
σημαντικά	σημαντικος
σημαντικά	σημαντικος
σημαντικές	σημαντικος
σημαντική	σημαντικος
σημαντικής	σημαντικος
σημαντικό	σημαντικος
σημαντικότερο	σημαντικος
σημαντικότερος	σημαντικος
σημαντικότερους	σημαντικος
σημαντικών	σημαντικος
σημαντικότητα	σημαντικοτητα
σημασία	σημασια
σημασίας	σημασια
σηματοδοτήσει	σηματοδοτω
σημεία	σημειο
σημείο	σημειο
σημείων	σημειο
σημειωθείσα	σημειωθεισα
σημειώθηκε	σημειωνω
σημειώνεται	σημειωνω
σημείωσα	σημειωνω
σημείωσαν	σημειωνω
σημείωσε	σημειωνω
σημειωθεί	σημειωνω
σημειώθηκαν	σημειωνω
σημειώθηκε	σημειωνω
σημειώνει	σημειωνω
σημειώνουμε	σημειωνω
σημειώσει	σημειωνω
σημειώσετε	σημειωνω
σημειώσουμε	σημειωνω
σημερινά	σημερινος
σημερινές	σημερινος
σημερινή	σημερινος
σημερινής	σημερινος
σημερινό	σημερινος
σθεναρά	σθεναρα
σιάνοι	σιανος
σιγοφούντωνε	σιγοφουντωνω
σιδηροδρομικές	σιδηροδρομικος
σιδηροδρομικού	σιδηροδρομικος
σιδηροδρομικό	σιδηροδρομικος
σιδηρού	σιδηρους
σιδηρούν	σιδηρους
σιδηροδρόμου	σιδηροδρομος
σιντριβάνια	σιντριβανι
σινόμπε	σινομπε
σιφνέικα	σιφνεικος
σκάνδαλα	σκανδαλο
σκάνδαλο	σκανδαλο
σκανδάλου	σκανδαλο
σκανδάλων	σκανδαλο
σκάντουρα	σκαντουρα
σκάφη	σκαφος
σκέφτονται	σκεφτομαι
σκεφτεί	σκεφτομαι
σκεφτούμε	σκεφτομαι
σκεφτόμαστε	σκεφτομαι
σκέψεις	σκεψη
σκέψης	σκεψη
σκήνωμα	σκηνωμα
σκίαθο	σκιαθο
σκεπτικό	σκεπτικο
σκεύη	σκευος
σκηνικό	σκηνικος
σκιάθο	σκιαθος
σκιάθος	σκιαθος
σκιάθου	σκιαθος
σκιαγραφήσω	σκιαγραφω
σκληρά	σκληρα
σκληρότερα	σκληρα
σκληρές	σκληρος
σκληροί	σκληρος
σκοπεύει	σκοπευω
σκοπεύετε	σκοπευω
σκοπεύουμε	σκοπευω
σκόπευε	σκοπευω
σκοπός	σκοπος
σκοπούς	σκοπος
σκοπό	σκοπος
σκοπός	σκοπος
σκορ	σκορ
σκοράρει	σκοραρω
σκόραρε	σκοραρω
σκόρπισε	σκορπιζω
σκοτωθεί	σκοτωνω
σκοτώθηκαν	σκοτωνω
σκοτώθηκε	σκοτωνω
σκοτώνουν	σκοτωνω
σκοτώσει	σκοτωνω
σκότωσαν	σκοτωνω
σκουλούδη	σκουλουδης
σκόμπυ	σκομπυ
σκόνες	σκονη
σκόνης	σκονη
σκοπίων	σκοπια
σλάβους	σλαβος
σλαβομακεδονική	σλαβομακεδονικος
σλαβομακεδονικής	σλαβομακεδονικος
σλαβομακεδόνων	σλαβομακεδονας
σλαβόφωνοι	σλαβοφωνος
σλαβόφωνους	σλαβοφωνος
σλόγκαν	σλογκαν
σμιτ	σμιτ
σνοφ	σνοφ
σνόουντεν	σνοουντεν
σοβαρά	σοβαρα
σοβαρά	σοβαρος
σοβαρές	σοβαρος
σοβαρή	σοβαρος
σοβαρότατες	σοβαρος
σοβαρότερες	σοβαρος
σοβαρότητα	σοβαροτητα
σοβαρότητας	σοβαροτητα
σοβιετική	σοβιετικος
σοβιετικής	σοβιετικος
σοβιετικοί	σοβιετικος
σοβιετικούς	σοβιετικος
σοβιετικών	σοβιετικος
σοβιετική	σοβιετικος
σοβιετικοί	σοβιετικος
σοβιετικό	σοβιετικος
σοκ	σοκ
σοκάκια	σοκακι
σολωμού	σολωμος
σομπιμπόρ	σομπιμπορ
σος	σος
σοσιαλδημοκρατική	σοσιαλδημοκρατικος
σοσιαλισμό	σοσιαλισμος
σοσιαλιστών	σοσιαλιστης
σοσιαλιστική	σοσιαλιστικος
σοσιαλιστικό	σοσιαλιστικος
σουλτάν	σουλταν
σουμάν	σουμαν
σουνίτες	σουνιτης
σουνιτών	σουνιτης
σουνγκ	σουνγκ
σουνιτικής	σουνιτικος
σοφία	σοφια
σούπες	σουπα
σούπερ	σουπερ
σπάνια	σπανια
σπάνια	σπανια
σπάνια	σπανιος
σπάνιες	σπανιος
σπάνιος	σπανιος
σπάσει	σπαω
σπέρνουμε	σπερνω
σπείρετε	σπερνω
σπήλαια	σπηλαιο
σπίτι	σπιτι
σπίτια	σπιτι
σπιτιού	σπιτι
σπιτιών	σπιτι
σπανίζουν	σπανιζω
έσπευσε	σπευδω
σπορ	σπορ
σποράδων	σποραδες
σπουδαίο	σπουδαιος
σπουδαιότερες	σπουδαιος
σπουδαιότητα	σπουδαιοτητα
σπρώξει	σπρωχνω
σπυρίδωνα	σπυριδωνας
σπυρίδων	σπυρις
σπόρτινγκ	σπορτινγκ
στάδιο	σταδιο
στάδια	σταδιο
στάδιο	σταδιο
στάλιν	σταλιν
στάση	σταση
στάσης	σταση
στάφο	σταφο
στέγη	στεγη
στέκουν	στεκω
σταθεί	στεκω
στελέχη	στελεχος
στελεχών	στελεχος
έστειλε	στελνω
στέλνει	στελνω
στέλνεται	στελνω
στέλνουμε	στελνω
στέλνουν	στελνω
στείλει	στελνω
στείλουν	στελνω
στέμματος	στεμμα
στεφάνου	στεφανο
στέφανος	στεφανος
έστησε	στηνω
στήριγμα	στηριγμα
στήριξη	στηριξη
στήριξης	στηριξη
στίνας	στινας
στα	στα
στα	στα
σταδιακά	σταδιακα
σταδιακή	σταδιακος
σταθά	σταθας
σταθεροποιηθεί	σταθεροποιω
σταθερή	σταθερος
σταθερός	σταθερος
σταθερότητας	σταθεροτητα
σταθερότητα	σταθεροτητα
σταθερότητας	σταθεροτητα
σταθμευμένα	σταθμευω
σταθμού	σταθμος
σταθμό	σταθμος
σταλινική	σταλινικος
σταμάτησε	σταματω
σταματάει	σταματω
σταματήσει	σταματω
σταματήσουμε	σταματω
στατιστικά	στατιστικος
σταυρί	σταυρι
σταυροειδής	σταυροειδης
σταυρού	σταυρος
σταυρός	σταυρος
σταυρόσχημο	σταυροσχημο
σταϊκούρας	σταικουρας
στεγάζει	στεγαζω
στεγάζονται	στεγαζω
στενά	στενα
στενά	στενος
στενό	στενος
στενός	στενος
στενότερους	στενος
στη	στη
στη	στη
στη	στη
στη	στη
στην	στην
στην	στην
στην	στην
στηρίζεται	στηριζω
στηρίζουν	στηριζω
στηρίξουμε	στηριζω
στηριχθεί	στηριζω
στηριζόμενοι	στηριζομενος
στιγμές	στιγμη
στιγμή	στιγμη
στιγμής	στιγμη
στις	στις
στις	στις
στις	στις
στις	στις
στις	στις
στο	στο
στο	στο
στο	στο
στο	στο
στο	στο
στοές	στοα
στοίχισαν	στοιχιζω
στοιχεία	στοιχειο
στοιχείο	στοιχειο
στοιχείων	στοιχειο
στον	στον
στον	στον
στον	στον
στον	στον
στουπίτσας	στουπιτσα
στουρνάρας	στουρναρας
στους	στους
στους	στους
στοχεία	στοχεια
στοχοθεσίες	στοχοθεσια
στρατευμάτων	στρατευμα
στρατεύματά	στρατευμα
στρατεύματα	στρατευμα
στρέβλωσης	στρεβλωση
στρεβλώσεων	στρεβλωση
στρέμματα	στρεμμα
στρεμμάτων	στρεμμα
στρέφεται	στρεφω
στραφεί	στρεφω
στραφώ	στρεφω
στρασβούργο	στρασβουργο
στρατηγική	στρατηγικη
στρατηγική	στρατηγικη
στρατηγικής	στρατηγικη
στρατηγική	στρατηγικος
στρατηγικών	στρατηγικος
στρατηγό	στρατηγος
στρατιωτικά	στρατιωτικα
στρατιωτικοί	στρατιωτικος
στρατιωτικές	στρατιωτικος
στρατιωτική	στρατιωτικος
στρατιωτικής	στρατιωτικος
στρατιωτικής	στρατιωτικος
στρατιωτικού	στρατιωτικος
στρατιωτικό	στρατιωτικος
στρατιωτικών	στρατιωτικος
στρατιωτικών	στρατιωτικος
στρατιωτών	στρατιωτης
στρατιώτες	στρατιωτης
στρατόπεδα	στρατοπεδο
στρατόπεδο	στρατοπεδο
στρατού	στρατος
στρατός	στρατος
στρατού	στρατος
στρατός	στρατος
στρατώνες	στρατωνα
στρατώνες	στρατωνας
στροφή	στροφη
στροφής	στροφη
στροφυλιά	στροφυλια
στρώμα	στρωμα
στρώματα	στρωμα
στόλος	στολος
στόλου	στολος
στόχαστρο	στοχαστρο
στόχος	στοχος
στόχο	στοχος
στόχοι	στοχος
στόχος	στοχος
στόχου	στοχος
στόχους	στοχος
στόχων	στοχος
συγγενείας	συγγενεια
συγγνώμη	συγγνωμη
συγγραφέας	συγγραφεας
συγκέντρωση	συγκεντρωση
συγκέντρωσης	συγκεντρωση
συγκεντρώσεις	συγκεντρωση
συγκίνηση	συγκινηση
συγκλήθηκε	συγκαλω
συγκατάθεση	συγκαταθεση
συγκαταλέγεται	συγκαταλεγω
συγκαταλέγονται	συγκαταλεγω
συγκατηγορουμένους	συγκατηγορουμενος
συγκατηγορούμενοί	συγκατηγορουμενος
συγκεκριμένα	συγκεκριμενα
συγκεκριμένα	συγκεκριμενα
συγκεκριμένα	συγκεκριμενος
συγκεκριμένα	συγκεκριμενος
συγκεκριμένες	συγκεκριμενος
συγκεκριμένη	συγκεκριμενος
συγκεκριμένο	συγκεκριμενος
συγκεκριμένοι	συγκεκριμενος
συγκεκριμένου	συγκεκριμενος
συγκεκριμένους	συγκεκριμενος
συγκεκριμένων	συγκεκριμενος
συγκεντρωτικά	συγκεντρωτικα
συγκεντρωτισμού	συγκεντρωτισμος
συγκέντρωσε	συγκεντρωνω
συγκεντρωθεί	συγκεντρωνω
συγκεντρώνουν	συγκεντρωνω
συγκεντρώσει	συγκεντρωνω
συγκοινωνιών	συγκοινωνια
συγκρίνεται	συγκρινω
συγκριτικά	συγκριτικα
συγκριτική	συγκριτικος
συγκροτήθηκε	συγκροτω
συγκρούστηκαν	συγκρουομαι
συγκρούστηκε	συγκρουομαι
συγκρότημα	συγκροτημα
συγκρότησης	συγκροτηση
συγκυρία	συγκυρια
συγχαίρω	συγχαιρω
συγχαίρω	συγχαιρω
συγχαρούμε	συγχαιρω
συγχαρώ	συγχαιρω
συγχαρητήριά	συγχαρητηρια
συγχαρητήρια	συγχαρητηρια
συγχρηματοδότησης	συγχρηματοδοτηση
συγχωνεύθηκαν	συγχωνευω
συγχώνευσης	συγχωνευση
συζήτησή	συζητηση
συζήτηση	συζητηση
συζήτησης	συζητηση
συζητήσεις	συζητηση
συζητήσεων	συζητηση
συζητάμε	συζητω
συζητήσαμε	συζητω
συζητήσει	συζητω
συζητήσουμε	συζητω
συζητείται	συζητω
συζητηθούν	συζητω
συζητούμε	συζητω
συκώτι	συκωτι
συλλέξουμε	συλλεγω
συνέλεξε	συλλεγω
συλλαλητήριο	συλλαλητηριο
συλλάβει	συλλαμβανω
συλλάβουν	συλλαμβανω
συλλήφθηκε	συλλαμβανω
συλλαμβάνουν	συλλαμβανω
συλληφθεί	συλλαμβανω
συνέλαβαν	συλλαμβανω
συνελήφθησαν	συλλαμβανω
συλληπήτηρια	συλληπητηρια
συλλογή	συλλογη
συλλογικό	συλλογικος
συλλογικών	συλλογικος
συλλυπητήριά	συλλυπητηριος
συμβάλει	συμβαλλω
συμβάλλει	συμβαλλω
συμβάλουμε	συμβαλλω
συνέβαλε	συμβαλλω
συμβάν	συμβαν
συμβάντων	συμβαν
συμβαίνει	συμβαινω
συμβαίνουν	συμβαινω
συμβεί	συμβαινω
συνέβη	συμβαινω
συμβασιούχος	συμβασιουχος
συμβατικά	συμβατικος
συμβατικές	συμβατικος
συμβατικών	συμβατικος
συμβατή	συμβατος
συμβιβασμού	συμβιβασμος
συμβιβασμούς	συμβιβασμος
συμβιβαστικές	συμβιβαστικος
συμβιβαστική	συμβιβαστικος
συμβολή	συμβολη
συμβολικών	συμβολικος
συμβουλίου	συμβουλιο
συμβούλιο	συμβουλιο
συμβούλια	συμβουλιο
συμεωνίδης	συμεωνιδης
συμεών	συμεων
συμμαχίας	συμμαχια
συμμαχία	συμμαχια
συμμαχίας	συμμαχια
συμμαχικού	συμμαχικος
συμμαχικών	συμμαχικος
συμμαχήσει	συμμαχω
συμμερίζομαι	συμμεριζομαι
συμμεριζόμαστε	συμμεριζομαι
συμμερίζομαι	συμμεριζομαι
συμμεριστώ	συμμεριζομαι
συμμετείχαν	συμμετεχω
συμμετάσχει	συμμετεχω
συμμετάσχουν	συμμετεχω
συμμετέχει	συμμετεχω
συμμετέχουν	συμμετεχω
συμμετείχαν	συμμετεχω
συμμετείχε	συμμετεχω
συμμετέχοντες	συμμετεχων
συμμετέχοντες	συμμετεχων
συμμετεχουσών	συμμετεχων
συμμετεχόντων	συμμετεχων
συμμετοχή	συμμετοχη
συμμετοχής	συμμετοχη
συμμορφώνεται	συμμορφωνω
συμμορφωθούν	συμμορφωνω
συμμορφώνεται	συμμορφωνω
συμμορφώνονται	συμμορφωνω
συμπέρασμά	συμπερασμα
συμπέρασμα	συμπερασμα
συμπεράσματα	συμπερασμα
συμπαράστασης	συμπαρασταση
συμπαρασταθούν	συμπαραστεκομαι
συμπαραταχθούν	συμπαρατασσομαι
συμπερίληψη	συμπεριληψη
συμπεριλάβαμε	συμπεριλαμβανω
συμπεριλάβει	συμπεριλαμβανω
συμπεριλάβουν	συμπεριλαμβανω
συμπεριλαμβάνεται	συμπεριλαμβανω
συμπεριλαμβάνονται	συμπεριλαμβανω
συμπεριλαμβάνοντας	συμπεριλαμβανω
συμπεριληφθεί	συμπεριλαμβανω
συμπεριληφθούν	συμπεριλαμβανω
συμπεριλαμβανομένης	συμπεριλαμβανομενος
συμπεριλαμβανομένου	συμπεριλαμβανομενος
συμπεριλαμβανομένων	συμπεριλαμβανομενος
συμπεριφορά	συμπεριφορα
συμπεριφοράς	συμπεριφορα
συμπληρωμένο	συμπληρωνω
συμπληρώνει	συμπληρωνω
συμπληρώνονται	συμπληρωνω
συμπληρώσει	συμπληρωνω
συμπλοκές	συμπλοκη
συμπολίτες	συμπολιτης
συμφέρον	συμφερον
συμφέροντά	συμφερον
συμφέροντα	συμφερον
συμφέροντος	συμφερον
συμφέρουσα	συμφερων
συμφιλίωση	συμφιλιωση
συμφιλίωσης	συμφιλιωση
συμφραζόμενα	συμφραζομενα
συμφωνίας	συμφωνια
συμφωνία	συμφωνια
συμφωνίας	συμφωνια
συμφωνίες	συμφωνια
συμφωνιών	συμφωνια
συμφωνηθείσα	συμφωνηθεις
συμφωνήσαμε	συμφωνω
συμφωνούμε	συμφωνω
συμφωνώ	συμφωνω
συμφωνήθηκε	συμφωνω
συμφωνήσουμε	συμφωνω
συμφωνήσουν	συμφωνω
συμφωνεί	συμφωνω
συμφωνηθεί	συμφωνω
συμφωνούμε	συμφωνω
συμφωνούν	συμφωνω
συμφωνούσαν	συμφωνω
συμφωνώ	συμφωνω
συμφώνησα	συμφωνω
συμφώνησαν	συμφωνω
συνάδελφοι	συναδελφος
συνάδελφος	συναδελφος
συνάδελφό	συναδελφος
συνάδελφός	συναδελφος
συναδέλφου	συναδελφος
συναδέλφους	συναδελφος
συναδέλφων	συναδελφος
συνάδει	συναδω
συνάδουν	συναδω
συνάλλαγμα	συναλλαγμα
συναλλάγματος	συναλλαγμα
συνάντηση	συναντηση
συνάντησης	συναντηση
συναντήσεις	συναντηση
συναντήσεων	συναντηση
συνάπτει	συναπτω
συνάπτονται	συναπτω
συνάπτουν	συναπτω
συνάψει	συναπτω
συνάρτηση	συναρτηση
συνεδρίου	συνεδριο
συνέδρια	συνεδριο
συνέδριο	συνεδριο
συνέλευση	συνελευση
συνέλευσης	συνελευση
συνέλευση	συνελευση
συνέλευσης	συνελευση
συνέντευξή	συνεντευξη
συνέντευξη	συνεντευξη
συνέντευξης	συνεντευξη
συνέπεια	συνεπεια
συνέπειες	συνεπεια
συνέπειες	συνεπεια
συνεπειών	συνεπεια
συνήλθε	συνερχομαι
συνέχειά	συνεχεια
συνέχεια	συνεχεια
συνέχιση	συνεχιση
συνήθεις	συνηθης
συνήθη	συνηθης
συνήθως	συνηθως
συναίνεση	συναινεση
συναγερμός	συναγερμος
συναθροίζεσθαι	συναθροιζεσθαι
συνακόλουθα	συνακολουθος
συναλλαγές	συναλλαγη
συναλλαγή	συναλλαγη
συναλλαγής	συναλλαγη
συνάντησαν	συναντω
συναντά	συναντω
συναντάμε	συναντω
συναντήθηκε	συναντω
συναντήσει	συναντω
συναντώνται	συναντω
συναπόφαση	συναποφαση
συνασπίζεσθαι	συνασπιζεσθαι
συνασπίστηκε	συνασπιζω
συνασπισμού	συνασπισμος
συνασπισμό	συνασπισμος
συνασπισμός	συνασπισμος
συναφών	συναφης
συνέδεαν	συνδεω
συνέδεε	συνδεω
συνδέεται	συνδεω
συνδέονται	συνδεω
συνδέσουμε	συνδεω
συνδεθεί	συνδεω
συνδιάσκεψη	συνδιασκεψη
συνδιαλλαγής	συνδιαλλαγη
συνδικάτων	συνδικατο
συνδυάζει	συνδυαζω
συνδυάζεται	συνδυαζω
συνδυάσουμε	συνδυαζω
συνδυασμένο	συνδυαζω
συνδυασμό	συνδυασμος
συνεδρίαση	συνεδριαση
συνεδριάσεις	συνεδριαση
συνειδητοποιώ	συνειδητοποιω
συνειδητοποίησα	συνειδητοποιω
συνειδητοποιούν	συνειδητοποιω
συνεισφέρουμε	συνεισφερω
συνεκτική	συνεκτικος
συνεννόηση	συνεννοηση
συνενωθούν	συνενωνω
συνεπάγεται	συνεπαγομαι
συνεπή	συνεπης
συνεπώς	συνεπως
συνεπώς	συνεπως
συνεργάζεται	συνεργαζομαι
συνεργαστείτε	συνεργαζομαι
συνεργάσιμος	συνεργασιμος
συνεργατών	συνεργατης
συνεργίες	συνεργια
συνεργασίας	συνεργασια
συνεργασία	συνεργασια
συνεργασίας	συνεργασια
συνεργεία	συνεργειο
συνεργείων	συνεργειο
συνεταιρίζεσθαι	συνεταιριζεσθαι
συνεχή	συνεχης
συνεχής	συνεχης
συνεχείς	συνεχης
συνέχιζαν	συνεχιζω
συνέχισε	συνεχιζω
συνεχίζει	συνεχιζω
συνεχίζεται	συνεχιζω
συνεχίζουν	συνεχιζω
συνεχίσει	συνεχιζω
συνεχίσετε	συνεχιζω
συνεχίσουμε	συνεχιζω
συνεχίσουν	συνεχιζω
συνεχίστηκε	συνεχιζω
συνεχισθεί	συνεχιζω
συνεχιστεί	συνεχιζω
συνεχιστούν	συνεχιζω
συνεχεία	συνεχεια
συνεχιζόμενη	συνεχιζομενος
συνεχόμενη	συνεχομενος
συνεχώς	συνεχως
συνηθισμένη	συνηθιζω
συνθέτουν	συνθετω
συνθήκη	συνθηκη
συνθήκης	συνθηκη
συνθηκών	συνθηκη
συνθήκες	συνθηκη
συνθήκη	συνθηκη
συνθηκών	συνθηκη
συνθετική	συνθετικος
συνθηκολόγηση	συνθηκολογηση
συνίστανται	συνιστω
συνιστά	συνιστω
συνιστούν	συνιστω
συνιστούσαν	συνιστω
συνιστώ	συνιστω
συνιστώντας	συνιστω
συνιστώσα	συνιστωσα
συνοδευτικό	συνοδευτικος
συνοδευόμενη	συνοδευομενος
συνοδεύει	συνοδευω
συνοδεύονται	συνοδευω
συνόδευαν	συνοδευω
συνοδοί	συνοδος
συνοικία	συνοικια
συνολικά	συνολικα
συνολική	συνολικος
συνολικού	συνολικος
συνομιλίες	συνομιλια
συνομιλιών	συνομιλια
συνομιλιών	συνομιλιων
συνομιλητές	συνομιλητης
συνομιλήσουν	συνομιλω
συνοπτικά	συνοπτικα
συνοπτική	συνοπτικος
συνοριακή	συνοριακος
συνοριακής	συνοριακος
συνοριακών	συνοριακος
συνοχή	συνοχη
συνοψίζει	συνοψιζω
συνοψίζονταν	συνοψιζω
συνοψίσατε	συνοψιζω
συνοψίσω	συνοψιζω
συντάκτες	συντακτης
συντάκτης	συντακτης
συντάσσει	συντασσω
συνέταξαν	συντασσω
συνέταξε	συντασσω
συνέτασσε	συντασσω
συντάξουμε	συντασσω
συνταχθώ	συντασσω
συνταγματαρχών	συνταγματαρχης
συνταγματάρχη	συνταγματαρχης
συνταγματικού	συνταγματικος
συνταγματικός	συνταγματικος
συνταγματοποίησης	συνταγματοποιηση
συντακτική	συντακτικος
συντακτικής	συντακτικος
συνταξιοδότηση	συνταξιοδοτηση
συντείνουν	συντεινω
συνετέλεσε	συντελω
συντελείται	συντελω
συντελεσθεί	συντελω
συντηρητικές	συντηρητικος
συντηρητική	συντηρητικος
συντηρητικής	συντηρητικος
συντηρητικοί	συντηρητικος
συντηρητικών	συντηρητικος
συντηρείτο	συντηρω
συντομία	συντομια
συντονισμένη	συντονιζω
συντονισμού	συντονισμος
συντονισμός	συντονισμος
συντονιστές	συντονιστης
συντριπτική	συντριπτικος
συνωμοσίας	συνωμοσια
συνόψιση	συνοψιση
συνύπαρξη	συνυπαρξη
συρία	συρια
συρίας	συρια
συριακές	συριακος
συριακή	συριακος
συριακής	συριακος
συσπείρωνε	συσπειρωνω
συσπειρωθούν	συσπειρωνω
συνέστησαν	συστηνω
συστηματικά	συστηματικα
συστηματικών	συστηματικος
συστοιχίες	συστοιχια
συσχετισμών	συσχετισμος
συχνά	συχνα
συχνότητα	συχνοτητα
συχνότητας	συχνοτητα
σφάλμα	σφαλμα
σφαγές	σφαγη
σφαγή	σφαγη
σφαγής	σφαγη
σφαιρική	σφαιρικος
σφαιρικό	σφαιρικος
σφραγίδα	σφραγιδα
σφυγμομέτρηση	σφυγμομετρηση
σχέδιά	σχεδιο
σχέδια	σχεδιο
σχέδιο	σχεδιο
σχέδιό	σχεδιο
σχεδίου	σχεδιο
σχεδίων	σχεδιο
σχέσεων	σχεση
σχέσεις	σχεση
σχέσεων	σχεση
σχέσεών	σχεση
σχέση	σχεση
σχέσης	σχεση
σχήμα	σχημα
σχήματός	σχημα
σχεδιάστηκε	σχεδιαζω
σχεδιασθεί	σχεδιαζω
σχεδιασμούς	σχεδιασμος
σχεδόν	σχεδον
σχετίζεται	σχετιζω
σχετίζονται	σχετιζω
σχετικά	σχετικα
σχετικά	σχετικα
σχετικά	σχετικος
σχετικά	σχετικος
σχετικές	σχετικος
σχετική	σχετικος
σχετικούς	σχετικος
σχετικό	σχετικος
σχετικών	σχετικος
σχηματίστηκε	σχηματιζω
σχημάτισαν	σχηματιζω
σχημάτισε	σχηματιζω
σχηματίζεται	σχηματιζω
σχηματίζονται	σχηματιζω
σχηματίσουμε	σχηματιζω
σχηματισμού	σχηματισμος
σχηματισμό	σχηματισμος
σχηματισμός	σχηματισμος
σχολή	σχολη
σχολής	σχολη
σχολεία	σχολειο
σχολείο	σχολειο
σχολείων	σχολειο
σχολιάσω	σχολιαζω
σχολιασμό	σχολιασμος
σχολικής	σχολικος
σχολικού	σχολικος
σχόλιο	σχολιο
σωκρατης	σωκρατης
σωματιδίων	σωματιδιο
σωματικής	σωματικος
σωμερίτη	σωμεριτης
σωρεία	σωρεια
σωστά	σωστα
σωστά	σωστα
σωστικά	σωστικος
σωστικών	σωστικος
σωστές	σωστος
σωστή	σωστος
σωστής	σωστος
σωστό	σωστος
σύβοτα	συβοτα
σύγκλησης	συγκληση
σύγκλισης	συγκλιση
σύγκριση	συγκριση
συγκρούσεις	συγκρουση
συγκρούσεων	συγκρουση
σύγκρουση	συγκρουση
σύγχρονα	συγχρονος
σύγχυση	συγχυση
συζύγους	συζυγος
συλλήψεως	συλληψη
σύλληψη	συλληψη
σύλληψης	συλληψη
σύλλογος	συλλογος
σύμβαση	συμβαση
σύμβασης	συμβαση
συμβάσεις	συμβαση
συμβάσεων	συμβαση
σύμβαση	συμβαση
σύμβασης	συμβαση
σύμβολο	συμβολο
σύμβουλο	συμβουλος
συμβούλους	συμβουλος
συμμάχων	συμμαχος
σύμμαχοί	συμμαχος
σύμμαχοι	συμμαχος
σύμμαχοι	συμμαχος
σύμπαντος	συμπαν
σύμπλεγμα	συμπλεγμα
σύμφωνα	συμφωνα
σύμφωνα	συμφωνα
συμφώνου	συμφωνο
σύμφωνο	συμφωνο
σύμφωνα	συμφωνο
σύμφωνο	συμφωνο
σύμφωνες	συμφωνος
σύμφωνο	συμφωνος
σύμφωνοι	συμφωνος
σύμφωνους	συμφωνος
σύναψη	συναψη
συνδέσεις	συνδεση
σύνδεσή	συνδεση
σύνδεσης	συνδεση
σύνθεση	συνθεση
σύνθεσης	συνθεση
σύνθετα	συνθετος
σύνθετο	συνθετος
σύνθημα	συνθημα
συνόδου	συνοδος
σύνοδο	συνοδος
σύνοδος	συνοδος
συνόδους	συνοδος
συνόλου	συνολο
σύνολο	συνολο
σύνολο	συνολο
σύνολό	συνολο
σύνορα	συνορο
συνόρων	συνορο
σύνορά	συνορο
σύνορα	συνορο
συντάγματος	συνταγμα
σύνταγμα	συνταγμα
συντάγματος	συνταγμα
σύνταγμά	συνταγμα
σύνταγμα	συνταγμα
συντάξεις	συνταξη
συντομότερα	συντομα
σύντομα	συντομα
συντομότερο	συντομος
σύντομη	συντομος
σύροι	συρος
σύρους	συρος
συρόταν	συρω
συστάσεις	συσταση
συστάσεων	συσταση
σύσταση	συσταση
συστήματα	συστημα
συστήματος	συστημα
συστημάτων	συστημα
σύστημα	συστημα
σώζεται	σωζω
σώζεται	σωζω
σώζονται	σωζω
σώζων	σωζων
σώματος	σωμα
σώματα	σωμα
τάγματα	ταγμα
τάγματος	ταγμα
ταγμάτων	ταγμα
ταγμάτων	ταγμα
τάξεις	ταξη
τάξεως	ταξη
τάξη	ταξη
τάσεις	ταση
τάση	ταση
τάσσεται	τασσω
τάσσονται	τασσω
τάχθηκε	τασσω
ταχθήκαμε	τασσω
ταχθήκατε	τασσω
τάταροι	ταταρος
τάφο	ταφος
τέλειοι	τελειος
τέλος	τελος
τέλη	τελος
τέλος	τελος
τέμενος	τεμενος
τέμπλο	τεμπλο
τένις	τενις
τέρμα	τερμα
τέρματα	τερμα
τερμάτων	τερμα
τέταρτον	τεταρτος
τέχνης	τεχνη
τέχνης	τεχνη
τήρηση	τηρηση
τίμημα	τιμημα
τιμίου	τιμιος
τίτλο	τιτλος
τίτο	τιτος
ταβέρνες	ταβερνα
ταβερνάκια	ταβερνακι
τακτικά	τακτικος
τακτική	τακτικος
τακτικού	τακτικος
τακτά	τακτος
ταλιμπάν	ταλιμπαν
ταμειακή	ταμειακος
τανκς	τανκς
ταξίδι	ταξιδι
ταξίδια	ταξιδι
ταξιαρχία	ταξιαρχια
ταξιαρχία	ταξιαρχια
ταξίδεψαν	ταξιδευω
ταξιδέψει	ταξιδευω
ταξιδεύει	ταξιδευω
ταπεινή	ταπεινος
ταπεινό	ταπεινος
ταράτσα	ταρατσα
ταρακουνήσει	ταρακουνω
ταρακουνήσουν	ταρακουνω
τατάρων	ταταρων
ταυτίζονται	ταυτιζω
ταυτόσημο	ταυτοσημος
ταυτότητα	ταυτοτητα
ταυτόχρονα	ταυτοχρονα
ταυτόχρονα	ταυτοχρονα
ταχύτερα	ταχεως
ταχογράφου	ταχογραφος
ταχυγράφος	ταχυγραφος
ταχυγράφων	ταχυγραφος
ταχυδρομείου	ταχυδρομειο
ταχυδρομείων	ταχυδρομειο
ταχυδρομική	ταχυδρομικος
ταχυδρομικής	ταχυδρομικος
ταχεία	ταχυς
ταχείας	ταχυς
ταχείς	ταχυς
ταχύτερες	ταχυς
ταχύτερη	ταχυς
ταχύτερο	ταχυς
ταχύτητας	ταχυτητα
ταχύτητες	ταχυτητα
ταύτισή	ταυτιση
τείχος	τειχος
τείχη	τειχος
τείχος	τειχος
τείχους	τειχος
τειχών	τειχος
τεθωρακισμένα	τεθωρακισμενος
τεθωρακισμένα	τεθωρακισμενος
τεκμηρίου	τεκμηριο
τελείως	τελειως
τελειοποίηση	τελειοποιηση
τελειώνοντας	τελειωνω
τελειώνω	τελειωνω
τελειώσουμε	τελειωνω
τελεσίδικη	τελεσιδικος
τελευταία	τελευταια
τελευταίο	τελευταιος
τελευταία	τελευταιος
τελευταίες	τελευταιος
τελευταίο	τελευταιος
τελευταίοι	τελευταιος
τελευταίοι	τελευταιος
τελευταίος	τελευταιος
τελευταίου	τελευταιος
τελευταίων	τελευταιος
τελικά	τελικα
τελικά	τελικα
τελικά	τελικος
τελική	τελικος
τελικό	τελικος
τελικός	τελικος
τελωνειακή	τελωνειακος
τελωνειακών	τελωνειακος
τελεί	τελω
τελείται	τελω
τεπέ	τεπε
τεράστιος	τεραστιος
τεράστια	τεραστιος
τεράστιας	τεραστιος
τεράστιες	τεραστιος
τεράστιο	τεραστιος
τεράστιους	τεραστιος
τερματίστηκε	τερματιζω
τερματισμό	τερματισμος
τερματοφύλακας	τερματοφυλακας
τετάρτη	τεταρτη
τετραήμερη	τετραημερος
τετραήμερων	τετραημερος
τετραγωνικών	τετραγωνικος
τετρακίονος	τετρακιονος
τετραμελής	τετραμελης
τεχεράνης	τεχερανη
τεχνικά	τεχνικα
τεχνικές	τεχνικος
τεχνική	τεχνικος
τεχνολογικές	τεχνολογικος
τεύχη	τευχος
τζακ	τζακ
τζαμί	τζαμι
τζο	τζο
τζορτζέτ	τζορτζετ
τζων	τζων
τζων	τζων
τζόγου	τζογος
τηλεγραφήματα	τηλεγραφημα
τηλεοπτικό	τηλεοπτικος
τηλεπικοινωνίες	τηλεπικοινωνια
τηλεφωνικά	τηλεφωνικα
τηλεφώνησε	τηλεφωνω
τηλεόραση	τηλεοραση
τηλεόρασης	τηλεοραση
τηρήσει	τηρω
τηρηθούν	τηρω
τηρούνται	τηρω
τι	τι
τιμές	τιμη
τιμή	τιμη
τιμής	τιμη
τιμών	τιμη
τιμητικού	τιμητικος
τιμολογήσουν	τιμολογω
τιμωρίας	τιμωρια
τιμωρήσουμε	τιμωρω
τιμωρούνται	τιμωρω
τμήμα	τμημα
τμήματά	τμημα
τμήματα	τμημα
τμήματος	τμημα
τμημάτων	τμημα
τοιχογραφίες	τοιχογραφια
τολμούσαμε	τολμω
τολμώ	τολμω
τομέα	τομεας
τομέας	τομεας
τομέων	τομεας
τομείς	τομεας
τομή	τομη
τομεακούς	τομεακος
τομεακών	τομεακος
τόνισε	τονιζω
τονίζει	τονιζω
τονίσω	τονιζω
τόνισε	τονιζω
τοπία	τοπιο
τοπίο	τοπιο
τοπίου	τοπιο
τοπικές	τοπικος
τοπική	τοπικος
τοπικής	τοπικος
τοπικού	τοπικος
τοπικών	τοπικος
τοποθετεί	τοποθετω
τοπωνυμίου	τοπωνυμιο
τουλάχιστον	τουλαχιστο
τουλάχιστον	τουλαχιστο
τουλίπα	τουλιπα
τουλούζη	τουλουζη
τουρίστες	τουριστας
τουριστών	τουριστας
τουρισμού	τουρισμος
τουρισμού	τουρισμος
τουρισμό	τουρισμος
τουριστική	τουριστικος
τουριστικού	τουριστικος
τουριστικό	τουριστικος
τουρκικών	τουρκικα
τουρκικός	τουρκικος
τουρκικά	τουρκικος
τουρκικές	τουρκικος
τουρκική	τουρκικος
τουρκικής	τουρκικος
τουρκικού	τουρκικος
τουρκικό	τουρκικος
τουρκοκρατίας	τουρκοκρατια
τουρκοκρατία	τουρκοκρατια
τουρκοκυπριακές	τουρκοκυπριακος
τουρκοκυπριακή	τουρκοκυπριακος
τουρκοκυπρίων	τουρκοκυπριος
τούνελ	τουνελ
τούρκοι	τουρκος
τούρκους	τουρκος
τούρκων	τουρκος
τράπεζα	τραπεζα
τράπεζας	τραπεζα
τράπεζα	τραπεζα
τράπεζες	τραπεζα
τρένο	τρενο
τρέφω	τρεφω
έτρεξε	τρεχω
τρέχοντα	τρεχων
τρέχοντος	τρεχων
τρέχουσα	τρεχων
τρέχουσας	τρεχων
τρέχων	τρεχων
τρίμηνη	τριμηνος
τρίτη	τριτη
τρίτης	τριτη
τρίτον	τριτος
τρίτου	τριτος
τρίτη	τριτος
τραβούσε	τραβω
τραγικών	τραγικος
τραπεζικών	τραπεζικος
τραπουλόχαρτα	τραπουλοχαρτο
τραυματίες	τραυματιας
τραυματίσθηκαν	τραυματιζω
τραυματίστηκαν	τραυματιζω
τραυματιστούν	τραυματιζω
τραυματισμός	τραυματισμος
τραύματά	τραυμα
τρεχούμενα	τρεχουμενος
τριάδα	τριαδα
τριήμερο	τριημερο
τριπλάσιος	τριπλασιος
τριπλασίασε	τριπλασιαζω
τρομαγμένοι	τρομαγμενος
τρομερός	τρομερος
τρομοκράτες	τρομοκρατης
τρομοκρατών	τρομοκρατης
τρομοκρατία	τρομοκρατια
τρομοκρατίας	τρομοκρατια
τρομοκρατικές	τρομοκρατικος
τρομοκρατική	τρομοκρατικος
τροπολογία	τροπολογια
τροπολογίας	τροπολογια
τροπολογίες	τροπολογια
τροπολογιών	τροπολογια
τροποποίησή	τροποποιηση
τροποποίηση	τροποποιηση
τροποποιήσεις	τροποποιηση
τροποποιήσει	τροποποιω
τροποποιηθεί	τροποποιω
τροποποιηθούν	τροποποιω
τροτσκιστές	τροτσκιστης
τροτσκιστής	τροτσκιστης
τρούλλο	τρουλλος
τρόικα	τροικα
τρόικας	τροικα
τρόπο	τροπος
τρόπος	τροπος
τρόπους	τροπος
τρόπων	τροπος
τροφίμων	τροφιμα
τροφίμων	τροφιμα
τρόφιμα	τροφιμα
έφαγαν	τρωω
τσάμπιονς	τσαμπιονς
τσίλι	τσιλι
τσακαλώτο	τσακαλωτος
τσε	τσε
τσικνιάδες	τσικνιας
τσιτσιμπίκου	τσιτσιμπικου
τσόρτσιλ	τσορτσιλ
τυποποιημένη	τυποποιω
τυραννίας	τυραννια
τύχουν	τυχαινω
τόκων	τοκος
τόκυο	τοκυο
τόνοι	τονος
τόνους	τονος
τόπο	τοπος
τόπος	τοπος
τόπους	τοπος
τόσο	τοσο
τόσο	τοσο
τότε	τοτε
τύπο	τυπος
τύπου	τυπος
τύπου	τυπος
τύχη	τυχη
τώρα	τωρα
τώρα	τωρα
υβ	υβ
υγείας	υγεια
υγεία	υγεια
υγείας	υγεια
υγειονομικές	υγειονομικος
υγιής	υγιης
υγροβιότοπους	υγροβιοτοπος
υδραγωγείο	υδραγωγειο
υδροβιότοπος	υδροβιοτοπος
υδρογόνο	υδρογονο
υδρολογικό	υδρολογικος
υεμένη	υεμενη
υεμένης	υεμενη
υιοθέτηση	υιοθετηση
υιοθετώντας	υιοθετω
υιοθέτησαν	υιοθετω
υιοθέτησε	υιοθετω
υιοθετήθηκαν	υιοθετω
υιοθετήθηκε	υιοθετω
υιοθετήσει	υιοθετω
υιοθετήσουμε	υιοθετω
υιοθετήσουν	υιοθετω
υλικό	υλικο
υλοποίησής	υλοποιηση
υλοποίηση	υλοποιηση
υλοποιήσουμε	υλοποιω
υλοποιηθεί	υλοποιω
υλοποιούνται	υλοποιω
υπάγεται	υπαγω
υπήγετο	υπαγω
υπάλληλος	υπαλληλος
υπαλλήλου	υπαλληλος
υπαλλήλων	υπαλληλος
υπάρχει	υπαρχω
υπάρχουν	υπαρχω
υπήρξε	υπαρχω
υπήρχαν	υπαρχω
υπάρξει	υπαρχω
υπάρξουν	υπαρχω
υπάρχει	υπαρχω
υπάρχουν	υπαρχω
υπήρξα	υπαρχω
υπήρξαν	υπαρχω
υπήρξε	υπαρχω
υπήρχαν	υπαρχω
υπήρχε	υπαρχω
υπάρχον	υπαρχων
υπάρχοντες	υπαρχων
υπάρχουσες	υπαρχων
υπέρ	υπερ
υπέρμετρες	υπερμετρος
υπέροχες	υπεροχος
υπήκοος	υπηκοος
υπαγορεύουν	υπαγορευω
υπαινίχθηκες	υπαινισσομαι
υπαινιχθεί	υπαινισσομαι
υπεισέρχεται	υπεισερχομαι
υπενθυμίζουμε	υπενθυμιζω
υπενθυμίζει	υπενθυμιζω
υπενθυμίσατε	υπενθυμιζω
υπενθυμίσει	υπενθυμιζω
υπενθυμίσω	υπενθυμιζω
υπενθύμισε	υπενθυμιζω
υπερ	υπερ
υπεραγορά	υπεραγορα
υπεραγορές	υπεραγορα
υπεραρκετή	υπεραρκετος
υπερασπιστούμε	υπερασπιζω
υπερβολές	υπερβολη
υπερβολικά	υπερβολικα
υπερβολικές	υπερβολικος
υπερβολική	υπερβολικος
υπερβολικούς	υπερβολικος
υπεργολαβικά	υπεργολαβικα
υπερεκτιμούμε	υπερεκτιμω
υπεροχή	υπεροχη
υπερσυντηρητικών	υπερσυντηρητικος
υπερψήφιση	υπερψηφιση
υπερψήφισε	υπερψηφιζω
υπερψηφίσει	υπερψηφιζω
υπερψηφίσετε	υπερψηφιζω
υπερψηφίσουμε	υπερψηφιζω
υπερψηφιστεί	υπερψηφιζω
υπευθυνότητα	υπευθυνοτητα
υπεύθυνες	υπευθυνος
υπεύθυνη	υπευθυνος
υπεύθυνοι	υπευθυνος
υπεύθυνοι	υπευθυνος
υπεύθυνους	υπευθυνος
υπηκοότητα	υπηκοοτητα
υπηρεσία	υπηρεσια
υπηρεσίας	υπηρεσια
υπηρεσιών	υπηρεσια
υπηρεσία	υπηρεσια
υπηρεσίας	υπηρεσια
υπηρεσίες	υπηρεσια
υπηρεσιών	υπηρεσια
υπηρεσιακή	υπηρεσιακος
υπηρέτησε	υπηρετω
υπνωτικό	υπνωτικος
υποβάθμιση	υποβαθμιση
υπέβαλαν	υποβαλλω
υπέβαλε	υποβαλλω
υπεβλήθησαν	υποβαλλω
υποβάλει	υποβαλλω
υποβάλλει	υποβαλλω
υποβάλλουμε	υποβαλλω
υποβάλλουν	υποβαλλω
υποβάλλω	υποβαλλω
υποβάλω	υποβαλλω
υποβλήθηκε	υποβαλλω
υποβληθεί	υποβαλλω
υποβολή	υποβολη
υποβολής	υποβολη
υποβρύχιο	υποβρυχιο
υπέγραψαν	υπογραφω
υπέγραψε	υπογραφω
υπεγράφη	υπογραφω
υπογράφηκαν	υπογραφω
υπογράφηκε	υπογραφω
υπογράψει	υπογραφω
υπογράμμισα	υπογραμμιζω
υπογράμμισε	υπογραμμιζω
υπογραμμίζει	υπογραμμιζω
υπογραμμίζετε	υπογραμμιζω
υπογραμμίζοντας	υπογραμμιζω
υπογραμμίσω	υπογραμμιζω
υπογραμμισθεί	υπογραμμιζω
υπογραφή	υπογραφη
υποδεχθούν	υποδεχομαι
υπέδειξε	υποδειχνω
υποδομής	υποδομη
υποδομών	υποδομη
υποθέτω	υποθετω
υποθέτω	υποθετω
υποθετικά	υποθετικα
υποκατάστατο	υποκαταστατος
υποκινούμενοι	υποκινω
υπέκλεψαν	υποκλεπτω
υπολείπονται	υπολειπομαι
υπολογίζεται	υπολογιζω
υπολογίστηκε	υπολογιζω
υπολογισμούς	υπολογισμος
υπολογιστές	υπολογιστης
υπομονή	υπομονη
υπονομεύει	υπονομευω
υπονομεύονται	υπονομευω
υπονομεύσει	υπονομευω
υπονοήσατε	υπονοω
υποσκάπτονται	υποσκαβω
υποστήριξή	υποστηριξη
υποστήριξη	υποστηριξη
υποστήριξης	υποστηριξη
υποστήριξε	υποστηριζω
υποστηρίζουμε	υποστηριζω
υποστήριξε	υποστηριζω
υποστηρίζει	υποστηριζω
υποστηρίζονταν	υποστηριζω
υποστηρίζουμε	υποστηριζω
υποστηρίζουν	υποστηριζω
υποστηρίζω	υποστηριζω
υποστηρίξαμε	υποστηριζω
υποστηρίξει	υποστηριζω
υποστηρίξουμε	υποστηριζω
υποστηρίξουν	υποστηριζω
υποστηρικτές	υποστηρικτης
υποσχόμενη	υποσχομενος
υποτελές	υποτελης
υποτιμούμε	υποτιμω
υποτροφίες	υποτροφια
υπουργείο	υπουργειο
υπουργείο	υπουργειο
υπουργείου	υπουργειο
υπουργοί	υπουργος
υπουργού	υπουργος
υπουργό	υπουργος
υπουργός	υπουργος
υπουργών	υπουργος
υπουργοί	υπουργος
υπουργός	υπουργος
υπουργών	υπουργος
υποφέρουν	υποφερω
υποχρέωσή	υποχρεωση
υποχρέωση	υποχρεωση
υποχρεώσεις	υποχρεωση
υποχρεώσεων	υποχρεωση
υποχρεώσεών	υποχρεωση
υποχρεούνται	υποχρεουμαι
υποχρεωτική	υποχρεωτικος
υποχρεωτικό	υποχρεωτικος
υποχρέωσαν	υποχρεωνω
υποχρέωσε	υποχρεωνω
υποχρεωθούν	υποχρεωνω
υποχρεωμένες	υποχρεωνω
υποχρεωμένοι	υποχρεωνω
υποχρεώνει	υποχρεωνω
υποχρεώνονται	υποχρεωνω
υποχρεώσουμε	υποχρεωνω
υποχωρήσει	υποχωρω
υποχώρησε	υποχωρω
υποχώρηση	υποχωρηση
υποψήφιας	υποψηφιος
υποψήφιες	υποψηφιος
υποψήφιοι	υποψηφιος
υποψήφιος	υποψηφιος
υποψήφιων	υποψηφιος
υποψηφίους	υποψηφιος
υποψηφίων	υποψηφιος
υποψηφίων	υποψηφιος
υποψία	υποψια
υποψηφιότητα	υποψηφιοτητα
υποψιάζομαι	υποψιαζομαι
υπόδειγμα	υποδειγμα
υποθέσεων	υποθεση
υποθέσεις	υποθεση
υπόθεση	υποθεση
υπόθεσης	υποθεση
υπολείμματα	υπολειμμα
υπόλογων	υπολογος
υπολοίπων	υπολοιπος
υπόλοιπα	υπολοιπος
υπόλοιπες	υπολοιπος
υπόλοιπη	υπολοιπος
υπόλοιπο	υπολοιπος
υπόλοιποι	υπολοιπος
υπόλοιπος	υπολοιπος
υπόλοιπους	υπολοιπος
υπόλοιπό	υπολοιπος
υπόσχεση	υποσχεση
υποσχέθηκαν	υποσχομαι
υποσχέθηκε	υποσχομαι
υποσχεθεί	υποσχομαι
υπόσχεται	υποσχομαι
υπόψη	υποψη
υφής	υφη
υπέστη	υφισταμαι
υποστεί	υφισταμαι
υφίσταται	υφισταμαι
υφηγητές	υφηγητης
υφιστάμενα	υφισταμενος
υφιστάμενων	υφισταμενος
υφισταμένη	υφισταμενος
υφισταμένου	υφισταμενος
υφισταμένων	υφισταμενος
υφυπουργός	υφυπουργος
υψόμετρο	υψομετρο
υψώθηκε	υψωνω
υψώνουμε	υψωνω
ύψωσε	υψωνω
υόρκη	υορκη
υόρκης	υορκη
φάκελος	φακελος
φακέλου	φακελος
φάουλ	φαουλ
φάρμακα	φαρμακο
φάρος	φαρος
φάσεις	φαση
φάση	φαση
φάσης	φαση
φάσμα	φασμα
φέρχοφστατ	φερχοφστατ
έφερε	φερω
έφερνε	φερω
φέρει	φερω
φέρεται	φερω
φέρνει	φερω
φέρονται	φερω
φέρουμε	φερω
φέρουν	φερω
εφέτος	φετος
φέτος	φετος
φήμες	φημη
φίλιπποι	φιλιππος
φιλίππου	φιλιππος
φιλίππους	φιλιππος
φιλίππων	φιλιππος
φιλίππων	φιλιππος
φίλους	φιλος
φαίνεται	φαινομαι
φαίνεται	φαινομαι
φαινόταν	φαινομαι
φανεί	φαινομαι
φαγητά	φαγητο
φαγητό	φαγητο
φαινομένου	φαινομενο
φαινόμενα	φαινομενο
φαινόμενο	φαινομενο
φαλούτζα	φαλουτζα
φαν	φαν
φανατικών	φανατικος
φανερό	φανερος
φανέρωνε	φανερωνω
φαράγγι	φαραγγι
φαρμακοποιοί	φαρμακοποιος
φαρούκ	φαρουκ
φασιστικού	φασιστικος
φεβρουαρίου	φεβρουαριος
φεντεραλιστές	φεντεραλιστης
φεστιβάλ	φεστιβαλ
φετινά	φετινος
φετινή	φετινος
έφυγε	φευγω
φεύγουν	φευγω
φημίζεται	φημιζομαι
φημίζονται	φημιζομαι
έφθανε	φθανω
φθάνει	φθανω
φθάσει	φθανω
φθάσουμε	φθανω
φθοράς	φθορα
φιλελευθέρων	φιλελευθερος
φιλελεύθερων	φιλελευθερος
φιλελεύθερα	φιλελευθερος
φιλελεύθερα	φιλελευθερος
φιλελεύθεροι	φιλελευθερος
φιλελεύθερος	φιλελευθερος
φιλικά	φιλικα
φιλικής	φιλικος
φιλικό	φιλικος
φιλικών	φιλικος
φιλιππίνες	φιλιππινες
φιλιππίνων	φιλιππινες
φιλιππίνων	φιλιππινες
φιλοβασιλική	φιλοβασιλικος
φιλοδοξίας	φιλοδοξια
φιλοδοξίες	φιλοδοξια
φιλοξενία	φιλοξενια
φιλοξενούμενοι	φιλοξενουμενος
φιλοξενεί	φιλοξενω
φιλοξενούνται	φιλοξενω
φιλοξενούσε	φιλοξενω
φιλοσοφία	φιλοσοφια
φιλόδοξη	φιλοδοξος
φιλόδοξο	φιλοδοξος
φλαμουριές	φλαμουρια
φλεγόμενες	φλεγομενος
φλούδα	φλουδα
φλόριντα	φλοριντα
φοβούμαι	φοβουμαι
φοβάμαι	φοβουμαι
φοβούμαι	φοβουμαι
φοβούνται	φοβουμαι
φοιτητές	φοιτητης
φοιτητών	φοιτητης
φοιτητική	φοιτητικος
φοιτητικό	φοιτητικος
φονικοί	φονικος
φονταμενταλισμό	φονταμενταλισμος
φορά	φορα
φορές	φορα
φορέα	φορεας
φορέων	φορεας
φορείς	φορεας
φορεία	φορειο
φορολογία	φορολογια
φορολογικές	φορολογικος
φορολογικής	φορολογικος
φορολογικών	φορολογικος
φορολογούμενο	φορολογουμενος
φορτηγά	φορτηγος
φορτηγά	φορτηγος
φορτηγού	φορτηγος
φούμιο	φουμιο
φούστερ	φουστερ
φραγκίσκο	φραγκισκος
φραγμούς	φραγμος
φραγμός	φραγμος
φρεγάτας	φρεγατα
φρικιαστική	φρικιαστικος
φρουρίου	φρουριο
φρούριο	φρουριο
φρουρίου	φρουριο
φρούριο	φρουριο
έφθασαν	φτανω
έφτασαν	φτανω
έφτασε	φτανω
φθάνουν	φτανω
φτάνει	φτανω
φτάνοντας	φτανω
φτάνουν	φτανω
φτάσει	φτανω
φτάσετε	φτανω
φτάσουμε	φτανω
φτα	φτα
φθηνή	φτηνος
φθηνό	φτηνος
φθηνότερη	φτηνος
έφτιαξαν	φτιαχνω
φυγή	φυγη
φυγαδεύτηκε	φυγαδευω
φυλάσσεται	φυλαγω
φυλάκιο	φυλακιο
φυλάκιση	φυλακιση
φυλάκισης	φυλακιση
φυλές	φυλη
φυλακή	φυλακη
φυλακισμένοι	φυλακιζω
φυλετικούς	φυλετικος
φυσικά	φυσικα
φυσικά	φυσικα
φυσική	φυσικος
φυσικής	φυσικος
φυσικού	φυσικος
φυσικό	φυσικος
φυσιολάτρες	φυσιολατρης
φυτών	φυτο
φωνάζοντας	φωναζω
φωνή	φωνη
φως	φως
φωταγώγηση	φωταγωγηση
φόντο	φοντο
φόρο	φορος
φόρους	φορος
φόρων	φορος
φύκη	φυκος
φύλλα	φυλλο
φύλων	φυλο
φύσεως	φυση
φύση	φυση
φύσης	φυση
φώκια	φωκια
χ	χ
χάλυβα	χαλυβας
έχασαν	χανω
χάθηκαν	χανω
χάνει	χανω
χάνουμε	χανω
χάνουν	χανω
χάσει	χανω
χάσουν	χανω
χαμένη	χανω
χαμένοι	χανω
χάουμε	χαουμε
χάραξης	χαραξη
χάρη	χαρη
χάρη	χαρη
χάρη	χαρη
χάρκιβ	χαρκιβ
χάρτ	χαρτ
χάρτη	χαρτης
χάρτη	χαρτης
χάσμα	χασμα
χέρι	χερι
χέρια	χερι
χίλαρι	χιλαρι
χίλιων	χιλιων
χίος	χιος
χίτες	χιτης
χίτλερ	χιτλερ
χαίρομαι	χαιρω
χάρηκε	χαιρω
χαίρεται	χαιρω
χαίρομαι	χαιρω
χαιρέτης	χαιρετης
χαιρετίζω	χαιρετιζω
χαιρετίζω	χαιρετιζω
χαιρετίσουν	χαιρετιζω
χαιρετίσω	χαιρετιζω
χαλάζι	χαλαζι
χαλάρωση	χαλαρωση
χαλαζόπτωσης	χαλαζοπτωση
χαλαρή	χαλαρος
χαλαρής	χαλαρος
χαμάχα	χαμαχα
χαμένη	χαμενος
χαμηλά	χαμηλος
χαμηλές	χαμηλος
χαμηλή	χαμηλος
χαμηλής	χαμηλος
χαμηλούς	χαμηλος
χαμηλό	χαμηλος
χαμηλότερης	χαμηλος
χαμηλότερο	χαμηλος
χαμόγελα	χαμογελο
χανάτου	χανατου
χαντάκι	χαντακι
χαντάκια	χαντακι
χανχ	χανχ
χαρά	χαρα
χαράζουν	χαραζω
χαρακτήρα	χαρακτηρας
χαρακτήριζε	χαρακτηριζω
χαρακτήρισε	χαρακτηριζω
χαρακτηρίζεται	χαρακτηριζω
χαρακτηρίζοντας	χαρακτηριζω
χαρακτηρίζουν	χαρακτηριζω
χαρακτηρίσει	χαρακτηριζω
χαρακτηριστεί	χαρακτηριζω
χαρακτηριστικά	χαρακτηριστικο
χαρακτηριστικά	χαρακτηριστικο
χαρακτηριστικό	χαρακτηριστικος
χαρακτηριστικά	χαρακτηριστικος
χαρακτηριστικό	χαρακτηριστικος
χαρακτηριστικότερα	χαρακτηριστικος
χαροποίησε	χαροποιω
χαρτί	χαρτι
χαρτογράφηση	χαρτογραφηση
χαρτογράφησης	χαρτογραφηση
χαρτονομίσματα	χαρτονομισμα
χασσάν	χασσαν
χασσάντ	χασσαντ
χατζησταμάτης	χατζησταματης
χαώδης	χαωδης
χδδ	χδδ
χείρας	χειρα
χειρισμού	χειρισμος
χειρισμούς	χειρισμος
χειρισμός	χειρισμος
χειροβομβίδες	χειροβομβιδα
χειροκροτήματα	χειροκροτημα
χειροτέρευσαν	χειροτερευω
χειρόγραφα	χειρογραφο
χερσαίες	χερσαιος
χερσονήσου	χερσονησος
χημική	χημικος
χθες	χθες
χθες	χθες
χθεσινή	χθεσινος
χιλιομέτρου	χιλιομετρο
χιλιομέτρων	χιλιομετρο
χιλιόμετρα	χιλιομετρο
χιονοδρομικό	χιονοδρομικος
χιονοπτώσεις	χιονοπτωση
χλωρίδας	χλωριδα
χοίρων	χοιρος
χολγκάντ	χολγκαντ
χονγκ	χονγκ
χορήγηση	χορηγηση
χορήγησης	χορηγηση
χορηγήσει	χορηγω
χορηγείται	χορηγω
χορηγούνται	χορηγω
χουάν	χουαν
χουρμάδες	χουρμας
χρέη	χρεος
χρέους	χρεος
χρεών	χρεος
χρήμα	χρημα
χρήματά	χρημα
χρήματα	χρημα
χρήση	χρηση
χρήσης	χρηση
χρήσιμα	χρησιμος
χρήσιμες	χρησιμος
χρήσιμη	χρησιμος
χρήστες	χρηστης
χρήστη	χρηστης
χρηστών	χρηστης
χρήστος	χρηστος
χρίσμα	χρισμα
χρειαζόμαστε	χρειαζομαι
χρειάζεται	χρειαζομαι
χρειάζονται	χρειαζομαι
χρειάστηκε	χρειαζομαι
χρειαζόμαστε	χρειαζομαι
χρειαστεί	χρειαζομαι
χρειαστούν	χρειαζομαι
χρεωθεί	χρεωνω
χρηματαγορών	χρηματαγορα
χρηματικού	χρηματικος
χρηματικό	χρηματικος
χρηματοδοτικά	χρηματοδοτικος
χρηματοδοτούμενη	χρηματοδοτουμενος
χρηματοδοτήθηκαν	χρηματοδοτω
χρηματοδοτήσει	χρηματοδοτω
χρηματοδοτείται	χρηματοδοτω
χρηματοδοτούμε	χρηματοδοτω
χρηματοδοτούν	χρηματοδοτω
χρηματοδοτήσεων	χρηματοδοτηση
χρηματοδότηση	χρηματοδοτηση
χρηματοδότησης	χρηματοδοτηση
χρηματοπιστωτικές	χρηματοπιστωτικος
χρηματοπιστωτικών	χρηματοπιστωτικος
χρησίμευε	χρησιμευω
χρησιμεύει	χρησιμευω
χρησιμοποίησαν	χρησιμοποιω
χρησιμοποίησε	χρησιμοποιω
χρησιμοποιήσαμε	χρησιμοποιω
χρησιμοποιήσει	χρησιμοποιω
χρησιμοποιήσουμε	χρησιμοποιω
χρησιμοποιήσουν	χρησιμοποιω
χρησιμοποιεί	χρησιμοποιω
χρησιμοποιείται	χρησιμοποιω
χρησιμοποιηθεί	χρησιμοποιω
χρησιμοποιούμε	χρησιμοποιω
χρησιμοποιούν	χρησιμοποιω
χρησιμοποιούνται	χρησιμοποιω
χρησιμοποιώντας	χρησιμοποιω
χρησιμότητά	χρησιμοτητα
χριστιανής	χριστιανη
χριστιανικών	χριστιανικος
χριστιανισμού	χριστιανισμος
χριστιανοδημοκρατικής	χριστιανοδημοκρατικος
χριστιανών	χριστιανος
χριστιανών	χριστιανος
χριστουγέννων	χριστουγεννα
χριστούγεννα	χριστουγεννα
χριστόφορος	χριστοφορος
χριστόφορου	χριστοφορος
χρονιά	χρονια
χρονική	χρονικος
χρονικού	χρονικος
χρονικό	χρονικος
χρονικό	χρονικος
χρυσέογλου	χρυσεογλου
χρυσής	χρυση
χρυσή	χρυσος
χρυσή	χρυσος
χρυσού	χρυσος
χρωματίζει	χρωματιζω
χρωστική	χρωστικος
χρόνιες	χρονιος
χρόνια	χρονος
χρόνο	χρονος
χρόνος	χρονος
χρόνου	χρονος
χρόνους	χρονος
χρόνων	χρονος
χρώμα	χρωμα
χτίστηκαν	χτιζω
χτίστηκε	χτιζω
χτισμένα	χτιζω
χτισμένη	χτιζω
χτισμένο	χτιζω
χτιστεί	χτιζω
χτυπήθηκε	χτυπω
χτυπούν	χτυπω
χτύπησαν	χτυπω
χτύπησε	χτυπω
χωρίζει	χωριζω
χωριό	χωριο
χωριά	χωριο
χωριού	χωριο
χωριό	χωριο
χωριών	χωριο
χωροφυλακή	χωροφυλακη
χωροφυλακής	χωροφυλακη
χόσνι	χοσνι
χωρών	χωρα
χώρα	χωρα
χώρας	χωρα
χώρες	χωρα
χωρών	χωρα
χώρα	χωρα
χώρας	χωρα
χώρες	χωρα
χώρο	χωρος
χώρος	χωρος
χώρος	χωρος
χώρου	χωρος
χώρους	χωρος
ψάρι	ψαρι
ψάχνουν	ψαχνω
ψήφισμα	ψηφισμα
ψήφισμα	ψηφισμα
ψηφίσματος	ψηφισμα
ψήφο	ψηφος
ψήφου	ψηφος
ψήφους	ψηφος
ψήφων	ψηφος
ψηλά	ψηλα
υψηλή	ψηλος
ψηλότερη	ψηλος
υψηλά	ψηλος
υψηλές	ψηλος
υψηλής	ψηλος
υψηλού	ψηλος
υψηλό	ψηλος
υψηλότερων	ψηλος
ψηλά	ψηλος
ψηλές	ψηλος
ψηλούς	ψηλος
ψηφίζεται	ψηφιζω
ψηφίζουμε	ψηφιζω
ψηφίζουν	ψηφιζω
ψηφίσαμε	ψηφιζω
ψηφίσουμε	ψηφιζω
ψηφιακού	ψηφιακος
ψηφιακό	ψηφιακος
ψηφοφορία	ψηφοφορια
ψηφοφορίας	ψηφοφορια
ψηφοφορίες	ψηφοφορια
ψηφοφόρων	ψηφοφορος
ψυχές	ψυχη
ψυχοτρόπων	ψυχοτροπος
ψυχρού	ψυχρος
ψυχρό	ψυχρος
ψυχρός	ψυχρος
ψωνίσουμε	ψωνιζω
ώθησε	ωθω
όντας	ων
ωράρια	ωραριο
ωραίο	ωραιος
ωραιοποιώντας	ωραιοποιω
ωριμάσετε	ωριμαζω
ως	ως
ως	ως
ωφελείας	ωφελεια
ωφελήσει	ωφελω
ωφελήσουν	ωφελω
όγκο	ογκος
όγκους	ογκος
όζον	οζον
όζοντος	οζον
όλγα	ολγα
όλο	ολο
όλο	ολο
όλα	ολος
όλες	ολος
όλοι	ολος
ολη	ολος
όλ'	ολος
όλα	ολος
όλα	ολος
όλες	ολος
όλη	ολος
όλο	ολος
όλοι	ολος
όλους	ολος
όλων	ολος
ομήρους	ομηρος
ομήρων	ομηρος
όμηροι	ομηρος
όμηροι	ομηρος
ομίλου	ομιλος
όμορφα	ομορφος
όμορφες	ομορφος
όμως	ομως
όνειρο	ονειρο
ονομάτων	ονομα
ονόματα	ονομα
ονόματος	ονομα
ονόματός	ονομα
όνομά	ονομα
όνομα	ονομα
όντως	οντως
όντως	οντως
όπλα	οπλο
όπλων	οπλο
όπου	οπου
όπως	οπως
όπως	οπως
όργανα	οργανο
όργανο	οργανο
ορίου	οριο
ορίων	οριο
όρια	οριο
όρια	οριο
όριο	οριο
όρκος	ορκος
όρος	ορος
όρους	ορος
όρο	ορος
όροι	ορος
όρος	ορος
όρος	ορος
όρους	ορος
όρων	ορος
όσκαρ	οσκαρ
όσο	οσο
όσον	οσο
όσο	οσο
όσον	οσο
όσο	οσος
ότου	οτου
οφέλη	οφελος
οφελών	οφελος
όφελος	οφελος
οχήματα	οχημα
οχήματός	οχημα
οχημάτων	οχημα
όχθες	οχθη
όχθη	οχθη
όχι	οχι
όχι	οχι
όψεως	οψη
ύδρα	υδρα
υδάτων	υδωρ
ύδατα	υδωρ
ύμνου	υμνος
ύπαρξη	υπαρξη
ύπατε	υπατος
ύπατο	υπατος
ύποπτη	υποπτος
υπόπτου	υποπτος
ύποπτη	υποπτος
ύποπτος	υποπτος
ύστερα	υστερα
υστέρων	υστερος
ύφεση	υφεση
ύψιστους	υψιστος
ύψος	υψος
ύψους	υψος
ύψωμα	υψωμα
ώθηση	ωθηση
ωρών	ωρα
ώρα	ωρα
ώρες	ωρα
ώριμο	ωριμος
(	(
)	)
,	,
και	και
τον	ο
για	για
την	ο
που	που
ότι	οτι
αυτή	αυτος
η	ο
σε	σε
μια	ενας
των	ο
οποία	οποιος
στην	στην
τη	ο
της	ο
κατά	κατα
.	.
Η	ο
δεν	δεν
τα	ο
:	:
μία	ενας
με	με
Αλλά	αλλα
του	ο
στο	στο
το	ο
οποίου	οποιος
στη	στη
Στο	στο
οι	ο
μέχρι	μεχρι
αυτού	αυτος
Αυτός	αυτος
ο	ο
αυτής	αυτος
στον	στον
μεταξύ	μεταξυ
ώστε	ωστε
Μια	ενας
οποίες	οποιος
μας	εγω
τους	ο
από	απο
τις	ο
Για	για
στις	στις
κάθε	καθε
-	-
ένα	ενας
δεκαπέντε	δεκαπεντε
πρώτη	πρωτος
Δεν	δεν
ή	η
Διότι	διοτι
δύο	δυο
Τα	ο
έναν	ενας
στα	στα
άλλο	αλλος
όταν	οταν
δεύτερο	δευτερος
τι	τι
Από	απο
Τι	τι
;	;
αυτό	αυτος
Με	με
τρίτη	τριτος
Και	και
ούτε	ουτε
μη	μην
αυτά	αυτος
διότι	διοτι
Αυτή	αυτος
αυτές	αυτος
τέτοια	τετοιος
Το	ο
πέντε	πεντε
αλλά	αλλα
άλλες	αλλος
ένας	ενας
άλλα	αλλος
πρώτο	πρωτος
οποίο	οποιος
άλλων	αλλος
οποίων	οποιος
αυτήν	αυτος
Στα	στα
"	"
ενώ	ενω
324.000	324.000
Κατά	κατα
1956	1956μ
Στη	στη
σ'	σε
350	350
Ο	ο
οποίος	οποιος
κάποιες	καποιος
Στον	στον
τεσσάρων	τεσσερις
Οι	ο
1.927	1.927
1.724	1.724
1.910	1.910
εναντίον	εναντιον
άλλους	αλλος
Στους	στους
135	135
35	35
22	22
64	64
1200	1200
538	538
όμως	ομως
καθώς	καθως
Εάν	αν
μην	μην
9	9
εν	εν
υπό	υπο
χιλιάδες	χιλιαδα
μιας	ενας
λόγω	λογω
300.000	300.000
30%	30%
12.000	12.000
δεύτερη	δευτερος
παρά	παρα
Ωστόσο	ωστοσο
αν	αν
ενός	ενας
Ούτε	ουτε
τίποτα	τιποτα
αυτός	αυτος
πως	πως
προκειμένου	προκειμενου
χωρίς	χωρις
ωστόσο	ωστοσο
όσα	οσος
Πέντε	πεντε
Γι'	για
Β'	β'
Τρίτη	τριτη
28	28
21	21
140	140
Την	ο
«	«
Όταν	οταν
»	»
στους	στους
οποίους	οποιος
γιατί	γιατι
Αυτό	αυτος
άλλη	αλλος
Προς	προς
Μετά	μετα
κατ'	κατα
οποίας	οποιος
δεύτερος	δευτερος
τρίτο	τριτος
1949	1949
Στην	στην
εκείνη	εκεινος
προς	προς
60	60
εννιά	εννεα
κατόπιν	κατοπιν
άλλοι	αλλος
οποίοι	οποιος
ενώπιον	ενωπιον
Δ'	δ'
Άλλοι	αλλος
εξ	εκ
όσων	οσος
Μέχρι	μεχρι
14	14
12	12
100	100
1990	1990
Ένας	ενας
υπερ	υπερ
Μετα	μετα
2	2
6	6
μέσω	μεσω
16	16
17	17
360/359	360/359
Β΄	β΄
Σε	σε
αυτόν	αυτος
8.000	8.000
4ου	4ος
πρώτης	πρωτος
1:0	1:0
2011-2012	2011-2012
51ο	51ος
15	15
8	8
μετά	μετα
500	500
όσους	οσος
εκ	εκ
Εν	εν
τω	ο
έναντι	εναντι
Ενώ	ενω
1	1
οποιαδήποτε	οποιοσδηποτε
Τον	ο
πρώτες	πρωτος
κάτι	κατι
01:00	01:00
52	52
Δύο	δυο
απ'	απο
31.000	31.000
έντεκα	ενδεκα
18	18
Ένα	ενας
115	115
επί	επι
0:1	0:1
δέκα	δεκα
Οκτώ	οκτω
πριν	πριν
10	10
Στις	στις
κανείς	κανενας
50	50
καθ'	κατα
Κατόπιν	κατοπιν
80	80
38	38
Αφού	αφου
δίχως	διχως
Α'	α'
11%	11%
Τρίτου	τριτος
άνευ	ανευ
τρεις	τρεις
Καθώς	καθως
11	11
οκτώ	οκτω
κάποια	καποιος
23	23
24	24
κανένας	κανενας
50%	50%
30	30
μου	εγω
σας	εγω
εσείς	εγω
καθένας	καθενας
!	!
τρία	τρεις
Πρώτο	πρωτος
άλλος	αλλος
Αλλο	αλλος
περί	περι
·	·
τούτο	τουτος
κανένα	κανενας
Αυτές	αυτος
εσάς	εγω
2012	2012
2013	2013
2020	2020
αρκετές	αρκετος
μερικές	μερικοι
εμάς	εγω
τούτου	τουτος
αυτοί	αυτος
πρώτων	πρωτος
εκείνες	εκεινος
3:0	3:0
πρώτος	πρωτος
4:0	4:0
υπέρ	υπερ
έβδομο	εβδομος
Είκοσι	εικοσι
Αν	αν
2:0	2:0
2010	2010
40.000	40.000
εκείνο	εκεινος
20.000	20.000
μερικών	μερικοι
αυτών	αυτος
έκτου	εκτος
Μεταξύ	μεταξυ
20%	20%
είτε	ειτε
5,75%	5,75%
ποιον	ποιος
καμία	κανενας
Όσοι	οσος
όσοι	οσος
κάποιος	καποιος
1,5	1,5
15ο	15ος
2:3	2:3
22ο	22ος
44'	44'
71ο	71ος
90ο	90ος
εκατό	εκατο
180	180
οπότε	οποτε
20	20
εξήντα	εξηντα
είκοσι	εικοσι
53%	53%
47%	47%
5%	5%
18-24	18-24
μ'	με
Αυτά	αυτος
11ης	11ος
2001	2001
εάν	αν
2014	2014
13	13
κι	και
αυτούς	αυτος
ώσπου	ωσπου
365	365
Εμείς	εγω
46	46
6ο	6ος
έως	εως
7ο	7ος
7ου	7ος
ποιο	ποιος
/	/
Αλλες	αλλος
γι'	για
εμείς	εγω
Σας	εγω
επειδή	επειδη
τέσσερα	τεσσερις
εκείνους	εκεινος
όποιος	οποιος
κάποιο	καποιος
1ης	1ος
450000	450000
75%	75%
17%	17%
16%	16%
13%	13%
έξι	εξι
Παρά	παρα
τέτοιου	τετοιος
Προκειμένου	προκειμενου
Εξ	εκ
13,6	13,6
Αντί	αντι
70%	70%
Τέτοια	τετοιος
ό,τι	ο,τι
πρώτα	πρωτα
Επί	επι
Βάσει	βασει
βάσει	βασει
ως	ως
49%	49%
3%	3%
36%	36%
29%	29%
12%	12%
400	400
39%	39%
61%	61%
48%	48%
60%	60%
35%	35%
54%	54%
Τρεις	τρεις
επτά	επτα
132524	132524
μόλις	μολις
1400	1400
2500	2500
1,4	1,4
τρίτης	τριτος
Έξι	εξι
1-2	1-2
2011	2011
2.240.000	2.240.000
1.8	1.8
45	45
εκατοντάδες	εκατονταδα
26	26
27	27
14%	14%
100%	100%
2009	2009
30000	30000
2006	2006
100000	100000
εγώ	εγω
εκείνον	εκεινος
ενάμισι	εναμισης
Τούτο	τουτος
εξαιτίας	εξαιτιας
μερικά	μερικοι
134	134
110	110
Μία	ενας
Πριν	πριν
7	7
1980	1980
200	200
75	75
Τους	ο
179	179
34	34
Απ'	απο
40	40
1.500	1.500
250	250
39	39
50.000	50.000
εκείνοι	εκεινος
10.000	10.000
5,8	5,8
3.32	3.32
15.000	15.000
αφού	αφου
8-9	8-9
5	5
ΕΝ	εν
90%	90%
2004	2004
2003	2003
ενόψει	ενοψει
43	43
μίας	ενας
εκατοντάδων	εκατονταδα
χιλιάδων	χιλιαδα
Σ'	σε
Εσείς	εγω
Τίνος	τινος
Των	ο
τριών	τρεις
τέταρτα	τεταρτος
εκείνα	εκεινος
τέτοιος	τετοιος
Αλλος	αλλος
οποίον	οποιος
Ποιο	ποιος
Τίποτε	τιποτα
εις	εις
κάποιον	καποιος
τρίτες	τριτος
τέτοιων	τετοιος
τέτοιες	τετοιος
εφόσον	εφοσον
Επ'	επι
δυο	δυο
1373	1373
Παρ'	παρα
'	'
δεκάδες	δεκαδα
31	31
37-40	37-40
74	74
τέτοιο	τετοιος
53	53
54	54
έκτο	εκτος
Χωρίς	χωρις
99η	99ος
85η	85ος
71η	71ος
οποιονδήποτε	οποιοσδηποτε
46η	46ος
33η	33ος
πρώτου	πρωτος
Κάθε	καθε
15%	15%
Επειδή	επειδη
αφ'	απο
ης	ος
άλλης	αλλος
Διπλή	διπλος
Δεύτερος	δευτερος
τρίτος	τριτος
διπλή	διπλος
διπλάσιο	διπλασιος
230	230
Γ'	γ'
88	88
1923	1923
1971	1971
1981	1981
1985	1985
δεύτερης	δευτερος
δια	δια
οποιοδήποτε	οποιοσδηποτε
21000	21000
40000	40000
460000	460000
στ'	στου
850	850
933	933
2007	2007
καθότι	καθοτι
οτιδήποτε	οτιδηποτε
καθεμία	καθενας
1999	1999
1991	1991
ποιες	ποιος
επ'	επι
μερικοί	μερικοι
70	70
3	3
αντί	αντι
4	4
0,05%	0,05%
Εφόσον	εφοσον
Προ	προ
μαυροπετρίτης	μαυροπετριτης
2.200	2.200
55	55
Δεκάδες	δεκαδα
Τη	ο
μένα	εγω
Μόλις	μολις
οιονδήποτε	οιοσδηποτε
Τις	ο
ανά	ανα
90	90
29.000	29.000
1988	1988
2002	2002
Ό,τι	ο,τι
19ου	19ος
πλην	πλην
Εκείνη	εκεινος
Αυτοί	αυτος
285	285
144ων	144ος
πρώτοι	πρωτος
65.3%	65.3%
15-25	15-25
520	520
10.029	10.029
103.784	103.784
98,5%	98,5%
6_-_12	6_-_12
τέσσερις	τεσσερις
61	61
40%	40%
αρκετοί	αρκετος
22ης	22ος
1η	1ος
41	41
δυόμισι	δυομισι
διπλό	διπλος
Υπό	υπο
απ’	απο
1944	1944
18ο	18ος
17ο	17ος
787	787
129	129
3.000	3.000
4.000	4.000
πέντε-δέκα	πεντε-δεκα
καθένα	καθενας
προ	προ
Λόγω	λογω
πενήντα	πενηντα
16ου	16ος
18ου	18ος
Ε'	ε'
ποιος	ποιος
ταύτα	ταυτα
τρείς	τρεις
10-13	10-13
33	33
6.000	6.000
250.000	250.000
7,5	7,5
Εξαιτίας	εξαιτιας
2.000	2.000
45%	45%
8%	8%
1.200	1.200
1989	1989
170	170
3:2	3:2
Δεκαεννέα	δεκαεννεα
03:30	03:30
O	ο
2000-2003	2000-2003
2003-2007	2003-2007
500.000	500.000
εννέα	εννεα
52.8	52.8
άλλου	αλλος
κανέναν	κανενας
τρίτων	τριτος
Υπ'	υπο
